17a-dihydroequilin	17a-dihydroéquiline
19-norprogesterone	19-norprogestérone
a 12 or above inclusive	score MMSE égal ou supérieur à 12
a 5-alpha reductase inhibitor for benign prostatic hyperplasia	inhibiteur de la 5-alpha réductase dans le traitement de l'hyperplasie bénigne de la prostate
abarticular gout	goutte abarticulaire
abdomen	abdomen
abdominal	abdominal
abdominal aortic aneurysm	anévrisme de l'aorte abdominale
abdominal ascitic extravasation	épanchement ascitique abdominale
abdominal cavity	cavité abdominale
abdominal pain	douleur abdominale
abdomino-pelvic cavity	cavité abdomino-pelvienne
abduction	abduction
abnormalities	anomalies
abnormal pap smear	frottis anormal
about Formulary and stocks	ici traduction d'une phrase concernant les formulaires hospitaliers pouvant être utile aux autres traducteurs.
above conventional clinical measures	augmentation des valeurs supérieure à la moyenne des constantes cliniques
abrupt closure	fermeture brutale
Abscess	Abcès
abscess	abcès
Abscissa	Abscisse
Absolute risk	Risque absolu
absorption	absorption
abstractor	enquêteur
abuse	abus
Acarid	Acarien
Acceptable risk	Risque acceptable
access	abord vasculaire
accessory	accessoire
access point	abord
Accrual	Recrutement
accumulates	Voir ci-dessous
Accupril	Accupril
Accuracy	Justesse Exactitude
ACE Inhibitors	angiotensin converting enzyme inhibitor
acetabular	acétabulaire
acetabular	cotyloïdien
acetabulum	acetabulum
acetate	acétate
achondroplasia	achondroplasie
Achromia	Achromie
Acibenzolar-S-methyl	acibenzolar-S-méthyle
acidifying	acidifiante
acid reflux	reflux acide
Acne	Acné
Acne rosacea	Acné rosacée
acne rosacea	couperose
Acne solaris	Acné solaire
aconitine	aconitine
Acquaintance network	Réseau de personnes de connaissance
acquired	acquise
acquired cystic kidney	kystes rénaux acquis
Acquired Immune Deficiency Syndrome related Services	Services connexes au Syndrome d'immunodéficience acquise
Acquired Immune Deficiency Syndrome	Syndrome d'immunodéficience acquise
acquired obstructive uropathy	uropathie obstructive acquise
Acrochordon	Acrochordon
Acrocyanosis	Acrocyanose
Acrokeratosis verruciformis	Acrokératose verruciforme
acromial bursa	bourse sus-acromiale
acromion	acromion
Actinic keratosis	Kératose actinique
action response	intervention
activated charcoal	charbon activé
Activated coagulation time	ACT
active implantable medical devices	dispositifs médicaux implantables actifs
Active vasculitis	Vasculite active
activities of daily living	activités de la vie quotidienne
activity	activité
actual blood flow rate	débit sanguin réel
Actuarial method	Méthode actuarielle
Actuarial rate	Taux actuariel
Actuarial table	Table actuarielle
Acute abcess	Abcès chaud
Acute	aiguë
acute	aigu
Acute Care Evidence Based Practice Committee	pratique factuelle
Acute gastro enteritis symptoms	Tableau de GEA
acute haemodialysis	hémodialyse aiguë
acute interstitial nephritis	néphrite interstitielle aiguë
Acute Kidney Injury	Insuffisance rénale aiguë
Acute Pulmonary Edema	APE
acute stage of full coma	grands comas en phase aiguë
Adaptation	Adaptation
additional doses	doses supplémentaires
Additive model	Modèle additif
adduction	adduction
Adenofibroma	Adénofibrome
Adenomyoma	Adénomyome
adhesions	adhérences
Adipose breast tissue	Tissu adipeux mammaire
adjacent fat	graisse de voisinage
Adjustment	Ajustement
administration	administration
administrative tasks	tâches administratives
administrator	administrateur
adrenal glands	surrénales
adrenal gland	surrenal glande
Adriamycin	Adriamycine
advice	conseil
aerated parenchyma	parenchyme aéré
Aerobe	Aérobie
Aerobiosis	Aérobiose
AeroChamber™ Plus	chambre de retenue valvée AeroChamber™ Plus
Aesthetic	Esthétique
aetiology	éthiology
affect	agir sur
Affected areas	Endroits affectés
afferent	afférent
affinity	affinité
A first-line treatment	de première intention
a follow-up care	un suivi médical
Age	Age
Age at death	Age au décès
agenesis	agénésie
Age-period cohort analysis	Analyse de cohorte par âge et période
Age-sex pyramid	Pyramide par âge et sexe Pyramide d'âge par sexe
Age-sex register	Registre par âge et sexe
Age-specific fertility rate	Taux de fécondité par âge
Age-specific rate	Taux par âge
Age spot	Tache de vieillesse
Age standardization	Standardisation pour l'âge
aggregate	agrégat
Aggregation bias	Vieillissement de la population
agonist	agoniste
agranulocyte	agranulocyte
Agreement	Infection transmise par voie aérienne
AIDS nephropathy	néphropathie du SIDA
Ail	Souffrir
Airborne infection	Consommation d'alcool
air embolism	embolie gazeuse
air filling	Réplétion aérique
air hunger	dyspnée de Kussmaul
air waves	Voies aériennes
airway obstruction	encombrement des voies respiratoires
airway obstruction	obstruction bronchique objectivée
Alanine aminotransferase	ALT
Albinism	Albinisme
Albino	Albinos
albumin	albumine
albuminuria	albuminurie
alcohol abuse	abus dalcool
alcohol	alcool
Alcohol consumption	Algorithme
alcoholism	alcoolisme
alcohol or drug abuse	consommation d'alcool ou de drogue
Algorithm	Algorithme clinique
Alkaline phosphatase	AP
alkaline phosphatase	phosphatase alcaline
alkaloid	alcaloïde
alkoxide	alcoolate
allantoin	allantoïne
Allele	Erreur de première espèce
Allergia	Allergie
allergic	allergique
Allergic reaction	Réaction allergique
allergic response	réaction allergique
Allergic response	Réponse allergique
allergology	allergologie
Allergy	Allergie
allergy	allergie
alleviate	atténuer
alleviation	atténuation
all heath insurance plans	toutes caisses médicales
allicin	allicine
allopathy	allopathie
allyl disulfide	disulfures d'allyles
aloe	aloès
alopecia	alopécie
Alopecy	Alopécie
Alpha error	Erreur de type alpha
Alpha error	Niveau alpha
alpha-immunotherapy	alpha-immunothérapie
Alpha level	Analyse de variance
Alzheimer	Alzheimer
Ambient air	AA
ambient temperature	tambiante
ambulance	véhicule sanitaire léger
ambulatory	ambulatoire
amenities	commodités
Amiba	Amibe
Amibic	Amibien
amikacin	amikacine
aminoglycoside	aminoglucoside
amoxicillin	amoxycilline
Amphotericin B IV	Amphotéricine B IV
Amphotericin B lipid	Amphotéricine B lipidique
ampicillin	ampicilline
amputation pain	douleur des amputés
amyelinated axon	axone non myélinisé
amygdalectomy	ablation des amygdales
amyloidosis	amylose
amyotrophic lateral schlerosis	sclerose externe amyotrophique
amyotrophy	amyotrophie
Anabolic hormones	Hormones anaboliques
anabolism	anabolisme
-anaemia	anémie
anaemia	anémie
anaesthesia	anesthésie
anaesthesia nerve block	anesthésie tronculaire
anaesthesiologist	anesthésiste
anaesthesiology	anesthésiologie
anaesthetic	anesthésique
anaesthetist	anésthésiste
anaesthetist	anesthestiste
analgesic abuse	abus danalgésiques
analgetics	analgésiques
analogue	analogique
anal sex	rapports anaux
analyse	analyse
analyser	analyseur
Analysis of variance	Epidémiologie analytique
Analytic epidemiology	Etude analytique
Analytic study	Modèle animal
anaphylactic	anaphylactique
anastomosis	anastomose
anatomical background	rappel anatomique
anatomically	anatomiquement
anatomy	anatomie
anchoring barbs	barbelures de fixation
ancillary action	effet accessoire
androgen	androgène
androgenic	androgénique
Androstenedione	Androstènedione
anephric	anéphrique
anesthetic agent	anesthésiant
anesthetic	anesthesique
aneurysmal	anévrismal
aneurysm	anévrisme
anger or embarrassment	colère ou gène
angina	angine
angina	angor
angina pectoris	angine de poitrine
angiocardiography	angiocardiographie
angio-computerized tomography	angio-CT
angio-CT	angio-computerized tomography
angiogram	angiogramme
angiographic	angiographique
angiography	angiographie
Angioma	Angiome
angioma	angiome
Angiomatosis	Angiomatose
angioplasty	angioplastie
angiotensin converting enzyme inhibitor	ACE Inhibitors
angular artery	artère angulaire
angular closure glaucoma	glaucome `a l'angle ferm'e
Anhistic	Anhiste
animal and cadaver labs	Laboratoires d'anatomopathologie animale et humaine
Animal model	Antagonisme
animal testing	essais sur les animaux
Anisocytosis	Anisocytose
Anisonucleosis	Anisocaryose
ankle	cheville
ankle has been crooked 90 degrees to the other side	Ci-dessous
ankylosis	ankylose
Annular	Annulaire
Anoxia	Anoxie
Ansa nephroni	Anse de Henle
Antagonism	Variable antécédente
antagonist	antagoniste
antenna	antenne
anterior	antérieur
anterior chamber	chambre anterieur
anthocyanins	anthocyanes
Anthraquinonic	Anthraquinonique
Anthropometry	Anthropométrie
anthropomorphic measurements	bilan anthropométrique
Anthropophilic	Anthropophilique
antiallergen	antiallergique
anti-androgenic	antiandrogénique
antiarrhythmic	antiarythmique
antibacterial	antibactérienne
Antibiotic	Antibiotique
antibiotic	antibiotique
antibiotic	antibiotiques
antibiotic sensitivity test	antibiogramme
antibiotic therapy	antibiothérapie
antibodies	anticorps
antibody	anticorps
Antibody	Anticorps
antibody	anticorps
anticoagulant	anticoagulant
anticoagulation	anticoagulation
anticonvulsant	anticonvulsivant
anti-convulsants	anti-convulsivants
Anti-dandruff	Antipelliculaire
antidepressant	antidépresseur
antidepressant	antidépressif
antidiabetic	antidiabétique
antiepileptic	antiépileptique
Antiepileptic Drug Pregnancy Registry	registre des grossesses sous traitement anti-épileptique
anti free-radical	anti radicaux libres
anti free-radical	anti-radicaux libres
antifungal	antifongique
antigen	antigène
Antigen	Antigène
Antigenic drift	Dérive antigénique
Antigenicity	Antigénicité
antigenicity	antigénicité
Antigenic shift	Mutation antigénique
antigladian antibody	aga
antihypertensive	antihypertensif
Anti-infective	Anti-infectieux
Anti-inflammatory	Anti-inflammatoire
anti-inflammatory	anti-inflammatoire
antiinflammatory	anti-inflammatoire
antimetabolite	antimétabolite
antimicrobial	antimicrobien
antineuralgic	antinévralgique
anti-oestrogenic	antioestrogénique
antioxidant	antioxydantes
antioxidant	anti-oxydant
antipain	anti-douleur
anti-parasitic	anti-parasitaire
Antiperspiration	Antitranspiration
antiphlogistic	antiphlogistique
anti-platelet	antiagrégeant plaquettaire
antipruritic	antiprurigineux
anti-psychotic	antipsychotique
antipyretic	antipyrétique
antipyrotic	antiphlogistique
antiradical	antiradicalaire
anti-resorptive	antirésorption
antirheumatic	antirhumatismal
Antisepsis	Antisepsie
Antiseptic	Antiseptique
antiseptic	antiseptiques
antispasmodic	antispasmodique
antitussive	antitussif
antiviral	antivirale
Anti-wrinkle	Anti-ride
antrum	antre
anuria	anurie
anxiety	angoisse
anxiety	anxiété
anxiolytic	anxiolytique
any disease	nimporte quelle maladie
Aorta	Ao
aorta	aorte
aortic aneurysm	anévrisme de laorte
aortic	aortique
aortic arch	arc aortique
aortic bifurcation	bifurcation aortique
aortic velocity-time integral	ITVA
aperitif	apéritif
aphrodisiac	aphrodisiaque
aphta	aphte
Aphtha	Aphte
apical systolic murmur with cephalad or upward propagation or radiation	souffle systolique en écharpe
a pin was inserted	une broche a été mise en place
aplasia	aplasie
Apocrine akne	Acné apocrine
aponeurosis	aponévrose
Apoplexy	Apoplexie
apparatus	appareil
apparatus	equipment
appendectomy	appendicectomie
appendicitis	appendicite
appetite stimulant	stimulant de lappétit
appraisal	évaluation
approach	conception
Approved for use in hospitals or Healthcare institutions	Agrée aux collectivités
approximately	environ
aqueous humor	humeur aqueuse
aqueous humour	humeurs liquides
arachidic acid	acide arachidique
arachnoiditis	arachnoïdite
arbitrarily	arbitrairement
Arbovirus	Arbovirus
arching	voussure
area	aire
area of low uptake	zone hypofixiante
Area sampling	Echantillonnage par zone
areola	aréole
Areola mammae	Aréole du mamelon
Areolitis	Inflammation de l'aréole du mamelon
Aristolochia acids	Acides aristolochiques
Arithmetic mean	Moyenne arithmétique
arms	bras
Arnica	Arnica
around the pons	péri-pontique
arrest	arrêt
arrythmia	arythmie
arsenic	arsenic
arterial	artériel
arterial catheterisation	cathétérisme artériel
Arterial hypertension	AHT
arterial line	ligne artérielle
arterial thrombosis	athérothrombose
arteries	artères
arteriosclerosis	artériosclérose
arteriotomy	artériotomie
arteriovenous	artério-veineux
arteriovenous fistula	fistule artério-veineuse
arteriovenous sheathotomy	adventicectomie artérioveineuse
artery	artère
arthralgia	douleur articulaire
arthritis	arthrite
arthritis	arthritiques
arthrocentesis	arthrocenthèse
arthrodial joint	articulation arthrodiale
arthrography	arthrographie
arthrolysis	arthrolyse
arthrometry	arthrométrie
arthropathy	arthropathie
arthrophyte	arthrophyte
arthroplasty	arthroplastie
arthroscopy	arthroscopie
Arthrosic	Arthrosique
arthrotomy	arthrotomie
articular	articulaire
artifactual stent stenosis	artéfact de sténose sur stent
artificial ankylosis	ankylose thérapeutique
Artificial intelligence	Intelligence artificielle
as a last resort	en désespoir de cause
Ascertainment bias	Biais de constatation Biais de détermination
ascites	ascite
ascorbic acid	acide ascorbique
Asepsis	Asepsie
a slight positive deflection	une petite positivité
aspartate aminotransferase	AST
Aspartate aminotransferase	AST
aspergillus	aspergillus
Aspersion	Aspersion
a spiral scan was performed	une hélice a été pratiquée
aspirin	aspirine
assays on board	dosages maxi
assessment	évaluation
assessment	répartition
Assistant and consulting physician	Adjoint vs Assistant
Assistant Head of Clinic	AHC
assistive device	appareil dassistance
associated	associé
Associate Dean	vice-doyen
associate doctor with extended term contract	attaché prorogé
Associate Specialist Gynaecologist and Obstetrician	médecin attaché en gynécologie-obstétrique
association	association
Association	Association
Association of Hearing Aid Practitioners	Association des audioprothésistes
Assortative mating	Accouplement préférentiel
Assumption	Prémisses
a standard ionisation procedure using glow discharge plasma	une procédure standard d'ionisation sous effluve de plasma
asthma	asthme
asthmatic	asthmatique
a strain of E. coli	une souche d'Escherichia coli
astrocyte	astrocyte
astrocytoma	astrocytome
astroglia	astroglie
Asymetric periflexural exanthem of childhood	Exanthème unilatéral thoracique de l'enfance
Asymmetrical association	Association asymétrique
Asymptotic	Asymptotique
Asymptotic method	Méthode asymptotique
ataxia	ataxie
ataxic	ataxique
at baseline	en conditions basales
at different levels	étagé
atelectasis	atélectasie
atheromatosis	athéromatose
atheromatous	athéromateux
atherosclerosis	athérosclérose
atherosclerotic artery	artère athéromateuse
atherosclerotic coronary disease	ASCD
athletic mouth guard	protège-dents athlétique
atlanto-occipital joint	articulation occipito-atloïdienne
at leading edge	au début de l'impulsion
atonic	atone
atonic	atonique
atonic bladder	atonie vésicale
atopic	atopique
Atopic dermatitis	Dermatite atopique
atopic dermatitis	dermatite atopique
atopic dermatitis	eczéma constitutionnel
Atrabilious	Atrabilaire
at rest	au repos
atrial	auriculaire
atrial fibrillation  AF	fibrillation auriculaire
atrial flutter  AF	flutter auriculaire
atrial wall	cloison de l'oreillette
atria	oreillettes
atrioventricular block	AVB
atrium	oreillette
attachment	ancrage
attachment	attachement
Attack rate	Taux d'attaque
attempted suicide	atteint de suicide
at the expense of the bypass	aux dépens de la dérivation
Attributable fraction	Fraction attribuable
Attributable number	Nombre attribuable
Attributable risk	Risque attribuable
Attribute	Attribut
attributed to	incriminer
attribute grid	grille des caractéristiques du produit
at trough of	à un nadir de
atypical form of	forme atypique de
atypical form of	forme fruste de
audible bilateral expiratory lung sounds or bilateral breath sounds	BEAB Bruits Expiratoires Audibles Bilatéraux
audiology	audiologie
audit & assignment privileges	vérifications et privilèges dassignation
Audit	Audit
Augmentation Communication Devices	appareils pour le développement de la communication
Auranofin	Auranofine
Auricular hydroa	Hydroa estival auriculaire
Aurothiopropanolsulfonate de sodium	Aurothiopropanolsulfonate de sodium
Auscultate	Ausculter
Auscultation	Auscultation
Australia	Australie
Authorized medicine	Médicament autorisé
autistic child	enfant autistique
auto-ajusting sensitivity tresholds	adaptation automatique des seuils de sensibilité
autoclave	autoclave
autoimmune	autoimmune
autoimmune disorders	troubles auto-immunes
autolysis	autolyse
autolyzed	autolysé
automated claims adjudication systems	systèmes automatisés de règlement des demandes de prestations
autopsy	autopsie
Autopsy data	Données d'autopsie
availability	disponibilité
avascular	avasculaire
AV canal	CAV
AV conduction block	blocage de la transmission auriculoventriculaire
Average life expectancy	Espérance de vie moyenne
Average	Moyenne
Average treatment time	Temps de traitement moyen
a visual inspection of the width of the CIs and the estimate of the treatment ef	visualisation de l'amplitude des IC
avoidance behavior	conduite d'évitement
Avoid contact	Éviter tout contact
Avonex	Avonex
Avulsion	Avulsion
avulsion	avulsion
award-winning project	projet primé
Awareness and Opinions	Attitudes et opinions
axial slice	coupe axiale
axilla	aisselle
axillary node	ganglion axillaire
Axis	Axe
axon	axone
axoplasm	axoplasme
azarole	azérole
Azathioprine	Azathioprine
azithromycin	azithromycine
Azotemia	Azotémie
b2-microglobulin	b2 microglobuline
Baby bather	Siège de bain
Baby carrier	Porte-bébé
baby formula	preparation lactee pour nourrison
bacillus	bacille
background and overview	contexte et présentation
back pain	douleurs dorsales
back-transformation of the regression line to the original unit	rétrotransformation de la droite de régression
bacopa monniera	bacopin
bacteraemia	bactériémie
Bacteria	Bactéries
Bacterial contamination	Contamination bactérienne
Bacterial invasion	Invasion bactérienne
Bactericidal agent	Agent bactéricide
Bactericidal	Bactéricide
bactericidal	bactéricide
Bacteriological	Bactériologique
bacteriology	bactériologie
bacterium	bactérie
Bactrim	bactrim
balance	equilibre
Bald	Chauve
Baldness	Calvitie
baldness	calvitie
ball-and-socket joint	articulation orbiculaire
balloon	ballonnet
balloon exchanges	changement de ballonnet
balloon gastrostomy tube	stomie à ballonnet
Balm	Baume
balm	baume
bamboo charcoal	fusain de bambou
bamboo hair	cheveu en bambou
band	bandelette
band	bande
band forms	formes à bâtonnet
band-like epigastric pain	en barre épigastrique
banff-1a subclinical acute rejection	Rejet aigu minime
barbiturate	barbiturique
Bar diagram	Diagramme en barres
barotrauma	barotraumatisme
Barrier cream	Crème barrière
basal cell	cellule basale
basal cells	cellules basales
Basal Medical Science	science médicale fondamentale
basal wall	paroi basal
based on incorrect notions as to	Mais tout cela repose sur ...
based on tricuspid regurgitation flow velocity	par le flux de
baseline pressure	pression de base
basic inferior infarction	infarctus inférieur rudimentaire
basophil	basophile
batch	lot
Bath oil	Huile de bain
Bayes' theorem	Théorème de Bayes
Beauty spot	Grain de beauté
become established	sinstaller
becomes common practice	passe dans les moeurs
bedpan	bassin
bed rest	repos au lit
Bed-sore	Escarre
bed-time	heure d'aller au lit
beet tops	fannes de betraves
behavioral	comportemental
behavioral disorder	troube de comportement
behavior	comportement
Behavioural epidemic	Epidémie de comportement
Behavioural risk factor	Facteur de risque lié au comportement
behaviour problems	troubles du comportement
bend	courber
bending	courbure
benefit	avantage
benefit	bénéfice
Benefit-cost ratio	Rapport avantages-coÝts
Benefit Utilization Department	Service dutilisation des prestations
Benign	Bénin
benign prostaic hyperplasia	hyperplasia prostatic bénin
Bennett's fracture	fracture de Bennett
benzodiazepines	benzodiazépines
beremi	bacopin
beremi	hysope d'eau
Berkson's bias	Biais de Berkson Biais de sélection
Bernoulli distribution	Distribution de Bernoulli
beta blockers	bêta-bloquants
beta carotene	bêta carotène
Beta error	Erreur de deuxième espèce Erreur de type bêta
Betaferon	Betaferon
Bias	Biais
Bias due to confounding	Biais lié aux facteurs de confusion Biais lié aux facteurs confondants
Bias due to digit preference	Biais lié à la préférence pour certains chiffres terminaux Biais d'arrondi
Bias due to instrumental error	Biais lié à l'instrument de mesure
Bias due to withdrawals	Biais lié aux retraits
Bias in assumption	Biais dans les prémisses
Bias in autopsy series	Biais dans les études basées sur les autopsies
Bias in handling outliers	Biais lié au traitement des valeurs extrêmes ou aberrantes
Bias in publication	Biais dans la publication des résultats
Bias in the presentation of data	Biais dans la présentation des données
Bias of an estimator	Biais d'un estimateur
Bias of interpretation	Biais d'interprétation
biceps muscle	biceps
bid	biquotidien
bid	bis in die
bid schedule	deux fois par jour
bifurcated	bifurqué
biliary colic	colique hépatique
Bill 33	Projet de la loi 33 du Québec
Bimodal distribution	Distribution bimodale
Binary variable	Variable binaire
binaural	prothese auditive stereophonique
binding	liaison
Binephrectomy	Binéphrectomie ou néphrectomie bilatérale
Binomial distribution	Distribution binomiale
bin with	durée de cycle
biocompatibility	biocompatibilité
biocompatible	biocompatible
biofeedback	biofeedback
biological activity	activité biologique
Biological License Application	Demande d'autorisation de mise sur le marché pour les produits biologiques et les produits issus d'un procédé biotechnologique
Biological plausibility	Plausibilité biologique
Biological transmission	Transmission biologique
Biometry	Biométrie
biopsy	biopsie
Biostatistics	Biostatistiques
biplane	en BP
bipolar disorder	troubles bi-polaire
bird arm	bras atrophié
bird pest	peste aviaire
Birth certificate	Certificat de naissance
Birth cohort analysis	Analyse de cohortes de naissance
Birth cohort	Cohorte de naissance
birth control	contraception
Birth defects	Anomalies congénitales
Birth interval	Intervalle entre deux naissances
Birthmark	Marque de naissance
birth mark	marque de naissance
Birth order	Rang de naissance
Birth rate	Taux de natalité
bisphosphonate	diphosphonate
Black Cohosh	Actée à grappe
blackout	etourdissement
B-lactam	B-lactamines
bladder distension	globe vésical
bladder impairment	atteinte vésicale
bladder infection	infection urinaire
bladder neck and prostatic obstruction	sclérose cervico-prostatique
bladder	vessie
blank	espace verte
bleeding	hémorragie
blepharitis	bl`epharite
blepharitis	blépharite
blinded batch no.	N° du lot en aveugle
Blind experiment	Expérience à l'aveugle
blind fistula	fistule borgne
blister	ampoule
Blister	Cloque
blister	cloque
blister package	plaquette thermoformée
blister strips	plaquettes thermoformées
Blocked randomization	Randomisation stratifiée
Blood Borne Pathogens	Pathogènes à diffusion hématogène
blood-brain barrier	barrière hémato-encéphalique
blood cell production	hemopoïèse
blood chemistries	biochimie sanguine
blood clot	caillot sanguin
blood clot	embolie artérielle
blood clots	caillots sanguins
blood clots	embolies artérielles
blood disease	hemothapie
blood disorders	troubles artériels
blood glucose test	HGT
Blood line	Tubulure de perfusion
blood platelet count	NF plaquettes
Blood pressure	BP
blood pressure	PA
blood	sang
blood sugar	la glycemie
blood transfusion	transfusion sanguine
blood type	groupe sanguin
blood typing	hémotypologie
bloody diarrhoea	diarrhée sanglante
blues	déprime
bodies	corps
bodies	corpuscules
body builders	anabolisants
body cavities	cavités du corps
body	corps
Body lice	Poux de corps
Body mass index	BMI
Body mass index	Indice de masse corporelle
Body odor	Odeur corporelle
body of the scapula	écaille de l'omoplate
Body surface area	BSA
boil	clou
Boil	Furoncle
bone block	butée osseuse
bone cell	cellule osseuse
bone graft	greffe osseuse
bone graft	greffon osseux
bone marrow	moelle osseuse
bone scans	scintigraphie
bone spur	bec-de-perroquet
bone stock	capital osseux
bone turnover	renouvellement des cellules osseuses
bone wedge	clavette osseuse
bony fusion	fusion osseuse
booster dose	dose de rappel
border cell	cellule bordante
boring pain	douleur térébrante
boron isotope B	isotope B du bore
Boron Neutron Capture Therapy	Thérapie par capture de neutrons par le bore
bother	gêner
bottle	biberon
bottle feeding	alimentation au biberon
bottulisme	bottulism
bound	fixé
bowel and bladder excretion	Préférences du patient en matière d'excrétion fécale et urinaire
bowel impairment	atteinte intestinale
bowel	intestin
bowel tendon	tendon fibrose
brachial fascia	aponévrose brachiale
brachiocarpal joint	articulation radio-carpienne
Brachiocephalic arterial trunk	BCAT
bradycardia	bradycardies
brain	cerveau
brain disorder	affection cérébrale
Brain freeze	Céphalée provoquée par le froid
brain metastases	métastases au cerveau
Brain natriuretic peptide	BNP
brain scan	scintigraphie du cerveau
brain surgery	chirurgie cérébrale
brain tumor	tumeur cérébrale
brain tumour	tumeur cérébrale
branches of medecine	disciplines médicales
branchial cartilage	cartilage branchial
Breach	Escarre
breakability test	essai de sécabilité
breakdown	defaillance nerveuse
breakdown	depression nerveuse
Breakpoint	Point de rupture
breast feeding	allaitement
breast feeding	allaitement maternel
Breast pump	Tire-lait
breath-holding attacks	spasmes du sanglot
breech position	la position anterieure
bridge	Pont dentaire
brightness	brillance
briser du systéme immunitaire	breakdown of immune system
brittle diabetes	diabète labile
Brittle nail syndrome	Ongles cassants
broad spectrum antibiotics	antibiotique à large spectre
bromine	brome
bromocriptine	bromocriptine
bronchitis	bronchite
bronchitis	bronchites
bronchopleural fistule	fistule broncho-pleurale
bronchoscopy	bronchoscopie
bronchospasm	bronchospasme
broncoscopy	bronchoscopie
Bulb	Bulbe
bulge	bombement
bulk	corpulence
bumper pads	tour de lit
bundle branch block  BBB	bloc de branche
Bunion	Oignon
bunion	oignon
buprenorphine	buprénorphine
burned-out fibrotic scarring or scare	cicatrice fibreuse d'involution spontanée
burning urination	brûlures mictionnelles
burnout	epuissement
Burn Wheel	Topographie des brûlures selon la méthode dite du Burn wheel'
bursa	bourse
bursectomy	bursectomie
bursitis	bursite
by abdominal incision	par voie haute
by Physician's Order	sur OM
by proliferation of the arachnoid membrane	Ci-Dessous
by retrograde transarterial approach using the right femoral artery	par abord trans-artériel rétrograde fémoral droit
bystander suppression	Effet immunosuppresseur non spécifique d'antigène
Byte	Octet
cable	câble
cable	fil métallique
cabon dioxide	gaz carbonique
caeco-colic junction	Jonction grêlo-colique
caesarean section	césarienne
caked breast	engorgement mammaire
calcaneocuboid joint	articulation calcanéo-cuboïdienne
calcaneus	calcaneum
calcification	calcification
calcified	calcifié
calcinosis circumscripta	calcinose cutanée
Calcitriol	Calcitriol
calcium and phosphorus levels	bilan phosphocalcique
Calcium Channel Blocker Products	Bloqueurs des canaux calciques
calcium citrate	citrate de calcium
calculus	calcul
calibration standard or calibrator	Point de gamme
calibrator	calibrateur
Caliper matching	Assortiment calibré
callus	cal osseux
camphor	camphre
camphor of the orient	camphre d'orient
Campylobacter	Campylobacter
Canadas Premier Health & Dental Benefits Specialist	Le grand spécialiste en prestations des soins de santé et dentaires au Canada
Canadian Institute for Health Information	Institut canadien dinformation sur la santé
Canadian Mental Health Association	Lassociation canadienne pour la santé mentale
canaliculus	canalicule
cancer	cancer
cancer causing	cancérigènes
cancer cell	cellule cancéreuse
cancer pain	douleurs néoplasiques
Cancer registry	Registre du cancer
cancer treatment	traitement contre le cancer
candidemia	candidémie
candidiasis by vagina	candidise vaginale
candididiasis by mouth	candidide buccale
cane crutches	cannes anglaises
Canker	Chancre
cannot be depolarized again	ne sera pas excité une deuxième fois
cannula	canule
capillary angioma	angiome capillaire simple
capillary	capillaire
capillary hemangioma	hémangiome plan
capped dispensing fee	honoraires professionnels plafonnés
capped ingredient costs	coûts plafonnés des ingrédients
cap polyposis	polypose duodénale
Capsule	Cpsl
capsule	gélule
capsulorrhaphy	capsulorraphie
capsulotomy	capsulotomie
captopril	captopril
caractère génetique	potreur d'une trait
carbamazepine	carbamézapine
carbohydates	hydrates de carbonne
carbohydrate	glucide
carbohydrates	glucides
carboplatin	carboplatine
carboy	la dame-jeanne
carbuncle	anthrax
Carcinogen	Carcinogène
carcinogenic	carcinogénique
carcinogenicity	carcinogénécité
carcinogenicity testing	tests de carcinogénécité
Carcinogenic substances	Substances carcinogéniques
Carcinoma	Carcinomes
cardiac arrest	arrêt cardiaque
cardiac arrest	arrêt du coeur
cardiac arrhythmias	arythmies cardiaques
cardiac depression	dépression cardiaque
cardiac index	index cardiaque
Cardiac intensive care unit	CICU
cardiac output  CO	débit cardiaque
cardiac output	débit cardiaque
cardiodepressant effect	action depressive cardiaque
cardiologist	cardiologue
cardiology	cardiologie
cardiomyopathy	cardiomyopathie
cardiopathy	cardiopathie
cardiopulmonary	cardiopulmonaire
cardiotomy	cardiotomie
cardiotonic	cardiotonique
cardiovascular	cardio-vasculaire
cardiovascular	cardiovasculaire
cardiovascular collapse	collapsus cardiovasculaire
Cardiovascular	CV
Cardiovascular disease	CD
Cardiovascular risk factors	CVRF
Cardiovascular surgery	CVS
carotene	carotène
carpal tunnel	syndrome canal carpien
carpal tunnel syndrome	Syndrome du canal carpien
carpectomy	carpectomie
Carrier	Porteur
carrier	porteur
carrying out the patch test	réalisation de la touche dessai
carry over effect	effet de rémanence
cartilage cell	cellule cartilagineuse
cartilages	cartilages
cartridge	cartouche
Case-base study	Etude cas-population
Case	Cas
case	cas
Case comparison study	Etude cas-témoins
Case compeer study	Etude cas-témoins
case conferences	cours des synthèses
case control study	devis cas-temoin
Case control study	Etude cas-témoins
Case fatality rate	Taux de mortalité parmi les nouveaux cas Taux de létalité
Case history study	Clinique:  étude d'une série de cas Epidémiologie:  étude cas-témoins
Case referent study	Etude cas-témoins
cash advance	avance en especes
catabolism	catabolisme
catamenial seizure	crise cataméniale
cataracta	cataracte
catchment area	territoire d'appartenance
catecholamines	catécholamines
category	catégorie
catheter	cathéter
catheter shaft	corps du cathéter
cat scan	scanner
cat scan	tomodensitométrie
CAT scan	tomographie
caudal	caudal
Causality	Causalité
Cause-deleted life table	Table de survie après exclusion d'une cause spécifiée de décès
Causes of death	Causes de décès
causes pain to someone	s'endoulerer
Cause-specific rate	Taux par cause
cauterisation	cautérization
cavity	carie
cavity	cavite
cefaclor	céfaclor
cefazolin	céfazoline
Celiac artery	CA
cell	cellule
cell membrane	membrane cellule
Cell regeneration	Régénération cellulaire
cells	cellules
Cellulitis	Cellulite
cellulitis	cellulite
cement	ciment
Censored data	Données censurées
Censoring	Censurer
Census	Recensement
Census tract	Secteur de recensement
Centile	Centile
central nervous system disease	affection du système nerveux central
central pain	douleur d'origine centrale
Centre for Clinical Research and Investigation	CRIC
centriole	centriole
cephalad	En direction céphalique
cephalexin	céfalexine
cephalosporin	céphalosporine
Ceratitis	Kératite
cerclage wiring	cerclage-haubanage
Cerebovascular accident	CVA
cerebral arteriosclerosis	artériosclérose cérébrale
cerebral palsy	infirmité motrice cérébrale
cerebral palsy	paralysie cérébrale
Cerebral venous sinus thrombosis	thrombophlébite de la veine cérébrale
cerebro-cardiac	cérébro-vasculaire
cérébrol	cérébrol
Cerotic	Cérotique
certificat d'études spéciales	C.E.S
certificate of hospitalization	un bulletin d'hospitalisation
ceruminous gland	glande cérumineuse
cervical cap	Diaphragme cervical
cesarean section	accouchement par césarienne
Cessation experiment	Expérience par arrêt de l'exposition
cessation of blood flow	arrêt du passage du sang
chafing of the skin	échauffement cutané
challenge	révélation
change	changement
changes	altérations
Changing mat	Matelas à langer
Changing mattress	Matelas à langer
chaplain	aumonier
Chapped skin	Engelure
chart	le dossier medical
Check digit	Octet de validation
Checking of data	Vérification des données
check-up	bilan de santé
cheekbone	-pommate
cheloids	chéloîdes
chemiluminescence	chimioluminescence
Chemoprophylaxis	Chimioprophylaxie
chemoreceptor	chimiorecepteur
chemotherapeutic	chimiothérapeutique
Chemotherapy	Chimiothérapie
chemotherapy	chimiothérapie
Cherry polypus	Polype en forme de cerise
Cherry red spot	Tache rouge cerise
Chest pain	douleur thoracique
chest	poitrine
chicken breast	thorax en carène
Chicken pox	Varicelle
chicken pox	varicelle
chief engineer	ingénieur en chef
chiken pox	varicelle
childhood illness	maladie d'enfance
childproof	voir explications
chills	frissons
Chloasma	Chloasma
chlorophyll	chlorophylle
Chlorosis	Chlorose
choke	s'etrangler
choke	suffocation
cholecalciferol	cholécalciférol
cholecystic diseases	Cholécystopathies
choledochotomy suture	suture de cholédocotomie
Cholera	choléra
Cholesteatoma	Cholestéatome
cholesterol	cholestérol
choline	choline
chondrectomy	chondrectomie
chondriosome	chondriosome
chondroblast	chondroblaste
chondroblastoma	chondroblastome
chondrodysplasia	chondrodysplasie
chondrodystrophy	chondrodystrophie
chondroitins	chondroïtines
chondroma	chondrome
chondromalacia	chondromalacie
chondromalacia patellae	chondromalacie rotulienne
chondromatosis	chondromatose
chondroporosis	chondroporose
chondrosarcoma	chondrosarcome
chondrotomy	chondrotomie
Chorio-melanoma	Sarcome choroïdien
choroiditis	choroïdite
choroid plexus tumours	tumeur du plexus
Christian science practitioner	praticien en science chrétienne
Chromatin	Chromatine
chromatin	chromatine
Chromatophoroma	Chromatophorome
Chromium Picolinate	Picolinate de chrome
Chromosomal anomaly	Aberration chromosomique
chromosomal	chromosomique
Chromosome	Chromosome
chromosome	chromosome
Chronic	Chronique
chronic	chronique
chronic fatigue	fatigue chronique
chronicity	chronicité
Chronic Kidney Disease	Insuffisance Rénale Chronique
chronic neurological pain	douleurs chroniques d'origine neurologique
Chronic obstructive pulmonary disease	COPD
chronic renal failure	CRF
chropractor	chiropracteur
Chymostasis	Stase intestinale du chyme
cicatrizant	cicatrisante
ciliary gland	glande ciliaire
cilium	cil
ciprofloxacin	ciprofloxacine
ciproflox	ciproflox
circular hemorrhage	hémorragie en nappe
circulating nurse	panseuse
circulation	circulation
circumcision	circoncision
circumduction	circumduction
Circumflex	Cx
circus movement	mouvement tournant
cirrhosis	cirrhose
cirrhosis of the liver	cirrhose du foie
cisplatin	cisplatine
cisterna chyli	citerne du chyle
cistern of Pecquet	citerne de Pecquet
Clammy skin	Peau froide et moite
clamp	clamp
clamped	clampé
clamping	clampage
clamp	pince
Class	Classe
Classification	Classification
Classification of diseases	Classification des maladies
Class social	Classe sociale
claviculectomy	claviculectomie
Cleansing bar	Pain de toilette
cleansing	détersion
Cleansing milk	Lait nettoyant
Cleansing	Nettoyage
clearance	blanchiment
cleidocranial dysostosis	dysostose cléido-crânienne
Clinical course in the department	Evolution dans le service
Clinical epidemiologist	Spécialiste en épidémiologie clinique
Clinical epidemiology	Epidémiologie clinique
clinical history	antécédents cliniques
clinical justification	argumentaire clinique
clinically healthy	au statut conventionnel
clinical stage II trial	essai clinique de phase II
clinical stage I trial	essai clinique de phase I
clinical staging	classification clinique
Clinical trial	Essai clinique
clinical trial	essai clinique
clinical union	consolidation clinique
clinician	clinicien
clip	agrafe
clockwise	dans le sens des aiguilles d'une montre
clogging	encombrement
Closed cohort	Cohorte fermée
closed fracture	fracture fermée
Closed question	Question fermée
clot	caillot
cloudy vision	vision trouble
clumping	compression
Cluster analysis	Analyse d'agrégats
Clustering	Formation d'agrégats ou de grappes
Cluster sampling	Echantillonnage en grappes
CMP 3-deoxy ...	3-desoxy CMP...
cmv	virus d'herpes
coagulant	coagulant
co-amoxyclav acid	association amoxycilline + acide clavulanique
coarse	grossier
coated tablet	comprimé pelliculé
coats ring	anneau cornéen de Coat
Cobalamin	Cobalamine ou vitamine B12
coccygodynia	coccygodynie
coccygotomy	coccygotomie
coccyx	coccyx
codeine	codéine
Coding	Coder
Coefficient of variation	Coefficient de variation
cognitive	cognitif
Cognitive decline	Détérioration des fonctions cognitives
cognitive lapses	trou bleu cognitif
Coherence	Cohérence
Cohort analysis	Analyse de cohorte
Cohort	Cohorte
Cohort incidence	Incidence dans une cohorte
Cohort slopes	Représentation graphique des taux par âge pour les cohortes de naissance
Cohort study	Etude de cohorte
Cointervention	Co-intervention
Cold abscess	Abcès froid
Cold chain	ChaÓne du froid
cold or flu	rhume ou grippe
cold	rhume
Cold sweat	Sueur froide
colectomy	colectomie
colic	coliques
colitis	colite
collagen	collagène
collagenosis	collagénose
collagenous fibre	fibre collagène
collapsed lung	collapsus pulmonaire
Collectively exhaustive classes	Classes collectivement exhaustives
Colle's fracture	fracture de Colle
collimation	collimation
Collinearity	Co-linéarité
Colloidal Silver	Argent colloïdal
colon	côlon
colonic mucosa	muqueuse de type colique
Colonization	Colonisation
colonoscopy	coloscopie
colon polyps	polype colon
colonscopy report	dossier de coloscopie
Colopathy	Colopathie
colposcopist	colposcopiste
coltis	colite
columnar cell	cellule cylindrique
columnar cell	cellule prismatique
Column of Bertin	Colonne de Bertin
coma	coma
combination of risk alleles	combinaison d'allèles à risque
Comedo	Comédon
Comfrey	Consoude
commander-in-chief	commandant en chef
Commensal	Commensal
comments	commentaires
commercially prepared homeopathic remedies for colic	préparations homéopathiques du commerce dans le traitement des coliques
comminutive fracture	fracture comminutive
commitment	engagement
common iliac artery	artère iliaque commune
commonly in high concentration	historiquement élevés
Common source epidemic	Epidémie de source commune
Common vehicle spread	Transmission par véhicule commun
Communicable disease	Maladie transmissible
Communicable period	Période de transmissibilité
communication	communication
community acquired	extra-hospitalière
community and social services	programmes communautaires et services sociaux
community-based private practice	médecin libéral vs médecin hospitalier
Community diagnosis	Evaluation de l'état de santé d'une collectivité
Community health	Santé communautaire
Community medicine	Médecine communautaire
Community trial	Essai dans une collectivité
Comparison group	Groupe de comparaison
Compendia listing	compendium médical
Compendium of Pharmaceuticals and Specialties	Compendium des produits et spécialités pharmaceutiques
compensatory leave re. overtime	récupération des heures supplémentaires
compensatory mechanisms	mécanismes de compensation
Competing cause	Cause concurrente
Competing risk	Risque concurrent
competitive inhibition	inhibition compétitive
complaint	doléance
complaints	inconvénients
Completed fertility rate	Descendance finale
complete heart block	bloc complet
Completing the clinical picture	Compléter le tableau clinique
Completion rate	Pourcentage de sujets avec données complètes
Complex Fractionated Electrograms	électrogrammes complexes fractionnés
Compliance	Observance
compliant	conformant
component	composant
Composite index	Indice composite
compounds	politique des composés extemporanés
compression fracture	fracture par tassement
compress wrapping	compresse d'arobage
computer compatible	compatible informatique
Computer	Ordinateur
concha	cornet
conchae	cornets
conclusions	conclusions
concomitant	parallèles
Concordance	Concordance
concurrent	simultanée
Concurrent study	Etude de cohorte
Conditional Drug Formulary™	Formulaire des médicaments conditionnelsMC
conditional drugs	médicaments conditionnels
Conditional probability	Probabilité conditionnelle
conduction	conduction
conductivity	conductibilité
conductor	chef d'orchestre
condyle	condyle
condyloid joint	articulation condylienne
condyloid joint	condylarthrose
condyloma acuminata	condylome acuminé
Condyloma of the penis	Condylome pénien
Confidence interval	Intervalle de confiance
Confidentiality	Confidentialité
confidentiality	confidentialité
confirmatory	confirmatoire
conformity	conformité
Confounding	Confusion
congenital	congénital
congenital heart disease	cardiopathies congénitales
congestion	congestion
conjugate	conjugué
connecting canaster	canister de liaison
connector	connecteur
connnective tissue disorder	trouble de tissue conjonctif
Consanguinity	Consanguinité
consent	consentement
Consequences	Séquelles
conservative patch-test	test épicutané ou test cutané ou
conservative patch-test	test épicutané ou test cutané ou patch-test fermé
conservative patch-test	test épicutané pu test cutané oupatch-test fermé
consideration	considération
consistency of skin	consistance de la peau
consistent radial force	force radiale constante
constipation	constipation
consultant	consultant
Consult instructions for use.	Veuillez consulter le mode d'emploi.
consumable	consommable
consumption	consommation
Contact dermatitis	Dermatite de contact
contact dermatitis	dermatite de contact
contact with Mycobacterium Tuberculosis Bacilli	URGENT: Contage tuberculeux bacillifère
Contagion	Contagion
containment group	groupe de contenance
Containment	Quarantaine régionale
Contaminated supplementary materials	Matériels annexes ou matériels accessoires
Contamination	Contamination
Contingency table	Table de contingence
contingent reversion	la revision conditionnelle
Contingent variable	Variable intermédiaire
continuous access	accès permanent
Continuous blood pressure measurement	CBPM
Continuous data	Données continues
continuous IV	continuous IV
continuous monitoring ... in the future	veille prospective
Continuous positive airway pressure	CPAP
Continuous variable	Variable continue
contractile cells	cellules contractiles
contraction	contraction
contracture	contracture
contraindicated	contre-indiqué
contraindicated	conttraint dit
Contra-indication	Contre-indication
contraindication	contre-indication
contralateral	controlatéral
contrast	contraste
Control	Contrôle
control	contrôle
controlled environment under nitrogen	zone contrôlée sous atmosphère dazote
Controlled formulary	Formulaire des médicaments contrôlés
controller therapy	Traitement d'entretien
Control of confounding	Contrôle des variables de confusion Contrôle des variables confondantes
contused	contuse
Contusion	Contusion
contusions	contusions
conventional	conventionnel
conventional treatment	traitement conventionnel
convulsion	convulsion
convulsions	convulsions
convulsive shock	convulsivothérapie
cooker	fricoteur
Cooling teether	Anneau de dentition à réfrigérer
Coordinates	Coordonnées
coordination	coordination
Copaxone	Copaxone
copd	bronchopneumopathie
co-polymer	co-polymère
Co-primary efficacy measures	les deux principaux critères d'efficacité
copy of relevant paraclinical investigations	copie des examens para-cliniques pertinents
cord	cordage tendineux
Cordon sanitaire	Cordon sanitaire
cordotomy	chordotomie
corium	corium
Corn	Cor
cornea	cornée
coronal fine cuts	coupes fines coronales
coronal	frontal
coronary angiography	coronarographique
coronary artery	artère coronaire
coronary artery disease  CAD	maladies coronariennes
coronary guiding catheter	cathéter-guide coronaire
Corpectomy	corpectomie
corpse	cadavre
Correlation coefficient	Coefficient de corrélation
Correlation	Corrélation
corrugated drain	lame multi-tubulée
cortex of bone	cortex osseux
cortical	cortical
cortical stroke	accident cortical
Corticosteroid	Corticostéroïde
corticosteroid	corticostéroïde
corticosteroids	corticostéroïdes
cortisol	cortisol
cortisone drug	cortisone synthétique
cortisone therapie	corticothérapie
Cost-benefit analysis	Analyse coÝts-avantages
Cost-effectiveness analysis	Analyse coÝt-efficacité
costosternal joint	articulation chondro-sternale
Cost Plus	Coût Plus
cost share	repartion des charges
Cost-utility analysis	Analyse coÝt-utilité
cot deaths	morts subites
cotton swab	le coton-tige
cotton swab	tige de coton
cough	toux
counter clockwise	dans le sens contraire de celui des aiguilles d'une montre
Covariance	Covariance
Covariate	Co-variable
Coverage	Couverture
Coverage for approved fees	Prise en charge du règlement agréé
coxa flexa	coxa flexa
coxalgia	coxalgie
coxarthritis	coxite
coxa vara	coxa vara
Cox model	Modèle de régression à effet proportionnel Modèle de Cox
coxofemoral joint	articulation coxo-fémorale
Cpsl	Capsule
Crab lice	Poux du pubis
Crack	Gerçure
Cradle crap	Croûtes de lait
cradle	le combine
cramping	crampes
cranberry	canneberge
craniad	en direction crânienne
cranial cavity	boîte crânienne
cranial ultrasound	echographie cérébrale
C-reactive protein	CRP
Creatinine	Créatinine
creatinine	créatinine
creeping paralysis	ataxie locomotrice
crepitation	crépitation
cricoarytenoid joint	articulation crico-aryténoïdienne
Criminal Injuries Compensation Board	Commission des blessures criminelles
criteria	critères
Criterion	Critère
crohn's disease	maladie de Crohn
Cronbach's alpha	Coefficient alpha de Cronbach
Cross-cultural study	Etude transculturelle
crossing vs insertion	franchissement vs insertion
cross-linking assay	essai de réticulation
cross-over	croisement
Crossover design	Plan d'étude croisé
Cross-product ratio	Rapport des cotes Rapport des produits croisés dans une table 2 x 2
Cross-sectional study	Etude transversale
crown	courronne
Crown of artichoke	corolle d'artichaut
Crude death rate	Taux brut de mortalité
crying from hunger	pleurer de faim
crying	pleurs
cryotherapy	cryothérapie
cryptic	dissimulé
Cryptococcus	cryptocoque
csf	lcr
cuboid cell	cellule cubique
culturally	au moyen de cultures
Cumulative death rate	Taux de décès cumulés
Cumulative incidence rate	Incidence cumulative
Cumulative incidence ratio	Rapport des incidences cumulatives
Cumulative survival rate	Probabilité cumulative de survie
cuneiform cartilage	cartilage cunéiforme
cup	cotyle
cure	guérison
curettage	curettage
current fertility	fécondité du moment
current field	champ électrique
current pathway	direction du choc
curvatrue	courboure verterale
Cushings syndrome	syndrome de Cushing
Customised hip implants	Fait sur mesure
Cusum	Acronyme pour 'somme cumulative d'une série de mesures'
cutaneoplantar reflexes	reflexes cutanéoplantaires
Cutaneous absorption	Absorption percutanée
cutaneous ellipse	ellipse cutanée
cutaneous gland	glande cutanée
Cut	Coupure
Cuticle	Cuticule
cuticle	cuticule
Cutis anserina perpetua	Pernion folliculaire acuminé de Klingmueller-Dittrich
cutting	decoupage
CV delay	délai CV
CXCR4-dependent signaling pathway	voie de signalisation CXCR4-dépendante
cyanocobalamin	cyanocobalamine
Cyanosis	Cyanose
Cyclooxygenase	Cyclo-oxygénase
cyclooxygenase	cyclo-oxygénase
cyclophosphamide	cyclophosphamide
Cyclosporin	Cyclosporine
Cyst count	Décompte des kystes
cyst formation	formation de kystes
Cystic acne	Acné kystique
cystic fibrosis	fibrose cystique
cystic fibrosis	mucoviscidose
cystic fibrosis	mucovisicidose
cystic osteofibromatosis	dysplasie fibreuse des os
cystitis	cystite
Cyst	Kyste
Cysts of the nose	Kystes du nez
cytology	cytologie
cytolysis	cytolyse
cytolysis with elevated ALT levels	cytolyse ALAT
cytometry	cytométrie
cytoplasm	cytoplasme
cytoscopy	cytoscopie
d-alpha-tocopherol	d-alpha-tocophérol
damage	dégât
damaged	endommagé
damage	détérioration
damage	dommage
damiana	damiane
Dandruff	Pellicule
data	donnée
Data processing	Traitement des données
Date of birth	Date de naissance
Date of death	Date de décès
daughter cell	cellule fille
Day Nursery Act	Loi des pouponnières
ddc	ddc
deafness	surdité
Death certificate	Certificat de décès
death	décès
Death rate	Taux de décès
Death registration area	Zone d'enregistrement des décès
debridement	débridement
Decision analysis	Analyse décisionnelle
decision for surgical debridement	Décision de regularisation
Decision tree	Arbre de décision
decreased gag	réflexe de haut le coeur diminué
decubitus ulcer	escarre
Deduction	Déduction
deep cervical node	ganglion latéral profond du cou
deep cleaning	nettooyage profondément dentaire
deeper layer	chorion
deep fascia	aponévrose profonde
Deep tendon reflexes	DTR
Deep vein thrombosis	DVT
defect	défaut
defective	anormal
defective	arriéré
defective	en mauvais état
defibrillator	défibrillateur
deficiency	déficient
deficiency	insufficience
definitive host	hôte définitif
deflate	dégonfler
deflation	dégonflage
deflation	dégonflement
deformability	déformabilité
deformitie	déformation
degeneration	dégénérescence
degenerative	dégénératif
degenerative neurologic disorder	affection neurologique dégénérative
Degree of moisture	Degré d'hydratation
Degrees of freedom	Degrés de liberté
dehydrated	déshydraté
Dehydroepiandrosterone	Déhydroépiandrostérone
delirium tremens	tremens de delirium
Delivery	Accouchement
delivery note	bulletin d'envoi
deltoid muscle	deltoïde
Demographic transition	Transition démographique
Demography	Démographie
Demonstration model	Modèle de démonstration
dendrite	dendrite
dendrite membrane	dendrolemme
dendritive	dendritique
Dengue fever	Dengue
denied surgery	récusé chirurgicalement
Denominator	Dénominateur
densitometry	densitométrie
Density of population	Densité de la population
Density sampling	Echantillonnage du type densité
Dependent variable	Variable dépendante
Depigment	Dépigmenter
deployment	déploiement
depolarization	dépolarisation
depressed fracture	embarrure
depressed fracture	enfoncement
deprivation	désafférence
déreglement immunitaire	immune disorder
derivative	dérivé
Derma	Derme
dermal papilla	bulbe pileux
Dermal ulcer	Ulcère dermique
Dermal uptake	Absorption dermique
dermatitis	dermatose
dermatitis	dermite
Dermatocandidiasis	Dermatocandidose
Dermatogen	Dermatogène
Dermatography	Dermatographie
dermatography	dermatographie
dermatography	dermographisme
dermatological compounds	composés dermatologiques
Dermatological	Dermatologique
Dermatologist	Dermatologue
Dermatology	Dermatologie
dermatology	dermatologie
dermatome	dermatome
Dermatomycosis	Dermatomycose
Dermatophyte	Dermatophyte
Dermatophytosis	Dermatophytose
dermatoscopy	dermatoscopie
Dermatose	Dermatose
Dermatosis	Dermatose
Dermis	Derme
Descriptive epidemiology	Epidémiologie descriptive
Descriptive study	Etude descriptive
Design	Plan d'étude
Design variable	Variable contrôlée par le plan de l'étude
desmosome	desmosome
Desquamation	Desquamation
destroys the abnormal tissue	détruit la zone
detachable	amovible
Detection	Détection
detection	détection
Determinant	Déterminant
determination	détermination
deterrent fees	franchises de prévention
detoxicant	désintoxiquant
detoxication	désintoxication
Detrusitol	Détrusitol
develop	apparaître
develop	faire
developmental disability	infirmité en evolution
development	développement
device	appareil
device	dispositif
devil's claw	griffe du diable
DF or defib	défibrillation
diabetes CV-outcome clinical trials	études de la morbi-mortalité cardiovasculaire liée au diabète
diabetes	diabète
diabetes mellitus	diabète sucré
diabetic	diabétique
diagnose	diagnostiquer
Diagnosis	Diagnostic
diagnosis	diagnostic
Diagnosis with sufficient medical information	Diagnostic argumenté avec linformation médicale nécessaire
diagnostic	diagnostique
Diagnostic index	Fichier des patients par diagnostic
diagnostic tools	outils diagnostics
dialysis	dialyse
dialyzer	dialyseur
diameter	diamètre
diaphragmatic hernia	hernie diaphragmatique
diaphragm	diaphragme
diaphyseal dysplasia	dysplasie diaphysaire
diarrhea	diarrhée
diarrhea	diarrhées
diarrhoea	diarrhée
diarthrodial joint	articulation diarthrodiale
diarthrosis	diarthrose
diathermy	diathermie
Dichotomous variable	Variable dichotomique
diet	alimentation
diet controlled	maitrisé par le régime alimentaire
dietician	Diététicien
Diet	Régime alimentaire
diets	régimes
different degrees of severity	plusieurs degrés
Differential misclassification	Erreur de classification différentielle
Diffusion capacity of lung for carbon monoxide	DLCO
digitalism	digitalisation
digitoxin	digitoxine
Digit preference	Préférence pour les chiffres ronds Préférence pour certains chiffres terminaux
digoxin	digoxine
dilatation	dilatation
dilated cardiomyopathy	cardiopathie dilatee
dilution ranges	gammes de dilution
Dimensionality	Dimensionalité
diminished enhancement	défauts de rehaussement
diphteria immunisation	vaccin anti-diphtérique
diplosome	diplosome
Direct adjustment	Ajustement direct
Direct standardization	Standardisation directe
Dirtily	Salement
disability and disabling evolution	invalidité et évolution invalidante
disability	handicap
Disability	Incapacité
disc degeneration	dégénérescence discale
disc disease	discopathie
disc disease	hernie discale
disc	disque
discectomy	discectomie
discharge	à la date de la sortie...
discharged	autorise a quitter l'hopital
discharge	depart
discharge	ecoulement
discharge	écoulement
discharge orders	ordres de medecin pour sortir de l'hopital
discharge papers	sortie d'hopital
discharge	sortie d'hôpital
discharge summary	Compte-rendu d'hospitalisation
discission	discision
discography	discographie
Discolouration	Décoloration
Discrete data	Données discrètes
Discrete variable	Variable discrète
Discriminant analysis	Analyse discriminante
Discussion Guide	Guide de discussion
Disease frequency survey	Enquête sur la fréquence des maladies
Disease label	Diagnostic
disease	maladie
Disease	Maladie
Disease odds ratio	Rapport des cotes de maladie
Disease registry	Registre des maladies
diseases of the vas deferens	maladies déférentes
Disease taxonomy	Taxinomie des maladies
disinfection and cleaning	aseptisation et nettoyage
disinfection	aseptisation
Disinfection	Désinfection
Disinfestation	Désinfestation
disk	disque intervertébral
disks of filter paper	papier confettis
dislocation	déboîtement
disorder	affection
disorders	anomalies
Dispersion	Dispersion
Disposable	à usage unique
disposal instructions	instructions concernant la mise à disposition
dissection	dissection
Disseminated eczema	Eczéma disséminé
dissociation	dissociation
Distal convoluted tubule	Tube contourné distal
distal	distal
distal end	extrémité distale
distal spacer resection	excision de l'espaceur distal
Distorter variable	Variable confondante
distress	détresse
distress	souffrance
Distribution	Distribution
Distribution function	Fonction de distribution
disturbance	délogement
diuretic	diurétique
diuretics	diurétiques
divert aqueous humor	divertir l'humeur aqueuse
DIY medical checks	autoexamen
dizzy-	vertigineux
DNA bank	biothèque
Docetaxel	Docétaxel
doctor	docteur
dog rose	églantier
dopamin	dopamine
Dopamine Agonists	Agonistes dopaminergiques
Doppler	Doppler
Doppler ultrasonography	echographie doppler
dorsal	dorsal
dosage	dosage
dose dependant	dose-dépendant
dose limiting	dose-limitant
Dose-response relationship	Relation dose-effet
double doctoring	obtention dordonnances multiples
double effusion sign	Le signe du double épanchement
Down	Duvet
down's syndrome	mongolisme
downs syndrome	trisomie
downward	vers le bas
drainage device	un appreil de drainage
drainage	drainage
dreglement climatique	climate disturbance
Drift	Dérive
Drill-biopsie	Ponction-bopie
drill bit	mèche
drip	goutte à goutte
driver	conducteur
drop in clinic	centre d'acceuil
drop in clinic	centre d'acceuil sans rendez vous
drop in hearing	baisse de l'audition
Droplet nuclei	Gouttelettes de Flügge
droplet nuclei	gouttelettes de Pflügge
drug class	catégorie du médicament
drug rash	eczéma médicamenteux
Drug Special Authorization form	formulaire dAutorisation spéciale de médicaments
drugs to slow the heart rate	médicaments pour ralentir
drug to drug separation	sans problème d'administration conjointe
Dry ice	Neige carbonique
dry mouth	bouche sèche
Dryness	Desséchement
Dry skin	Peau sèche
dry skin	peau sèche
Dual Chromogen Staining	double coloration par l'emploi des chromogènes
Duchenne type dystrophy	dystrophie musculaire progressive type Duchenne
ductless	dépourvu de canal excréteur
dull pain	douleur sourde
duly noted	prise en note
Dummy variable	Variable indicatrice
dura	dure-mère
during open-chest surgery	à thorax ouvert
dydyrmiv lupud	systemique lupus
Dynamic population	Population dynamique
dynamic postural control and asymmetry	stratégie dynamique d'asymmétrie
dyschondroplasia	dyschondroplasie
dyschondroplasia	enchondromatose
dysmenorrhea	dysménorrhée
dysostosis	dysostose
dyspepsia	dyspepsie
dysplasia	dysplasie
dyspnea	dyspnée
dystrophy	dystrophie
ear drum	membrane du tympan
early breast carcinoma	cancer primaire du sein
early diagnosis	diagnostic précoce
early diagnosis	diagnostique précoce
Early neonatal mortality rate	Taux de mortalité néonatale précoce
early school-age child	enfant de l'âge de la maternelle
Early warning system	Système d'alerte rapprochée
ear problems	problèmes d'oreilles
Ear thermometer	Thermomètre auriculaire
Eating habits	Habitudes alimentaires
Ecchymosis	Ecchymose
Echinococcus	Echinocque
eclampsia	clampsie
eclampsie	eclampsie
Ecological analysis	Analyse écologique
Ecological correlation	Corrélation écologique
Ecological fallacy	Sophisme écologique
Ecological study	Etude écologique
Ecology	Ecologie
Ecosystem	Ecosystème
ectopic pregnancy	grossesse ectopique
ectoplasm	ectoplasme
Eczema	Eczéma
eczema	eczéma
Eczema marginatum	Eczéma marginé
Edema of the lower limbs	ELL
edemas	oedèmes
Effect	Effet
effective	actif
effective	efficace
effectiveness	efficacité
Effectiveness	Efficacité
Effective sample size	Taille d'échantillon effective Taille d'échantillon après exclusions et abandons
effective travel	course utile
Effect measure	Mesure de l'effet
Effect modifier	Facteur modifiant
efferent	efférent
Effervescent table	Eff tblt
Efficacy	Utilité
efficacy vs effectiveness	Efficacité potentielle versus efficacité réelle
Eff tblt	Effervescent table
effusion	épanchement
Egg count	Décompte des oeufs
Ejection fraction	EF
eject the blood	éjectent le sang
ekg	electrocardiogramme
ekg	electroencephalogram
elastic basket	paroi élastique
elastic fibre	fibre élastique
elbow	coude
elderberries	baies du sureau
elderberry	baie de sureau
elderly	âgé
electrical impulses	impulsions électriques
electrodes	électrodes
Electrolysis	Electrolyse
electronic speech synthesizers	synthétiseurs électroniques de la parole
Elimination	Elimination
embolectomy	embolectomie
embolisation solely	l'embolisation seule
embolism	embolie
embolization	embolisation
embolus	embole
embryo	embryon
embryology	embryologie
emergency cash advance	depennage d'avance en especes
Emergency Medical Service	EMS
emergency room visit	visite de premiers secours
emesis	vomissement
emotional instability	dinstabilité émotionnelle
Empirical	Empirique
Employer Payroll System	système de paie de lemployeur
empyema	empyème
Enanthema	Enanthème
Encephalopathy	Encéphalopathie
Encounter	Rencontre
End-Diastolic Volume	EDV
Endemic disease	Maladie endémique
endocrinal	endocrinien
endocrine	endocrinienen
endocrinology	endocrinologie
Endoderm	Endoderme
end of haemodynamic support	sortie hémodynamique
endometrial cancer	cancer de lendomètre
endometriosis	endometriose
endometrium	endometre
endomyosium	endomyosium
endoneurium	endonèvre
endoplasm	endoplasme
endoprosthesis device	dispositif endovasculaire
endoscopy	endoscopie
endosteum	endoste
endothelial dysfunction	dysfonctionnement endothélial
endothelial	endothélial
endothelium	endothélium
endovascular	endovasculaire
endovascular repair	chirurgie endovasculaire
end spool	bobine d'extrémité
End stage renal disease	Insuffisance rénale terminale
End stage renal failure	Insuffisance rénale terminale
End-Systolic Volume	ESV
end-to-side prostheto-prosthetic anastomosis	anastomose prothéto-prothétique latéro-terminale
endurance athletes	sportifs dendurance
endurance sports	sports dendurance
engineering	génie
enlarged cardiac silhouette	étalement cardique
enlarged lymph glands	augmentation de glandes lymphatiques
enlarged lymph glands	ganglions lymphatiques dilatés
enlarged spleen	dilatation de la rate
enteritis	entérite
Entire Word	Abbreviation
enuresis	voir bed wetting
Environmental stress	Agressions dues à l'environnement
Environment	Environnement
enzyme activator	activateur enzymatique
enzyme	enzyme
enzyme pathway	voie enzymatique
enzymes	enzymes
enzymes system	complexe enzymathique
Eosinophilic peri-orificial granuloma	Granulome éosinophile péri-orificiel
Epidemic curve	Courbe épidémique
Epidemic	Epidémie Epidémique
Epidemic	Epidémique
Epidemiologist	Epidémiologiste
Epidermic	Epidermique
Epidermis	Epiderme
epidural anaesthesia	anesthésie épidurale
epidural  anesthesia	epidural anesthesie
epidural fibrosis	fibrose épidurale
epigastric	epigastre
epiglottic cartilage	cartilage épiglottique
epilepsy	epilepsie
epilepsy	épilepsie
epiphyseal cartilage	cartilage d'accroissement
Episode	Episode
epithelial cell	cellule épithéliale
epitope spread	libération d'épitopes autoantigéniques
Epornithic	Epizootie aviaire
epsomsalt	SEL D'EPSOM
equipment	équipement
equipment for prevention or treatment of decubitus ulcers	équipement pour la prévention ou le traitement des ulcères de décubitus
ergot	ergoline
erucic acid	acide érucique
eruption charts	les tables de sortie maxillaires
Eruption	Eruption
Erysipelas	Erysipèle
erysipeloid	rouget
Erythema	Erythème
Erythema gyratum Fuchs	Érythème polymorphe circiné de Fuchs
erythema pernio	engelures
erythrocyte	hématie
Erythropoietin	érythropoïétine
esophagus	esophague
esphogus	aesophage
essential fatty acid	acides gras essentiels
established CHD	maladie coronaire ou coronopathie avérée ou confirmée
established	confirmé
Estimate	Estimé
Estimation	Estimation
Estimator	Estimateur
estradiene	estradiène
estrous cycle	cycle oestral
etanus vaccination	vaccin anti-tétanique
Ethics	Ethique
ethmoid bone	ethmoïde
Ethnic group	Groupe ethnique
Etiologic study	Etude à visée étiologique
Etiology	Etiologie
étrier	stirrups
Europe	Europe
Evaluation	Evaluation
Evans' postulates	Postulats d'Evans
evening primrose oil	huile d'onagre
Event	Evénement
everyday aches and pains	les petits maux de tout les jours
evicted	Expulsé
evidence guided	guidance de preuve
Exact method	Méthode exacte
Exact test	Test exact
excentro-osteo chondrodysplasia	chondrodysplasie spondylo-épiphysaire
excessively slow heart rate	cadence trop lente
Excess rate among exposed	Taux en excès chez les exposés
Excess risk	Risque en excès
excision	excision
excitability	excitabilité
excitation	excitation
excreted	excrété
excretion	excrétion
Exelon	Exelon
exercise	exercice
exercise test	test deffort
Exfoliation treatment	Traitement exfoliant
exogenous	exogène
exostosis	exostose
Expanded programme on immunization	Programme élargi d'immunisation
Expectation of life	Espérance de vie
expectorant	expectorante
experienced	expérimenté
experience	expérience
Experiential variable	Variable indépendante
Experimental epidemiology	Epidémiologie expérimentale
Experimental study	Etude expérimentale
Experiment	Expérience
explanation	explication
Explanatory study	Etude explicative
Explanatory variable	Variable explicative
exploratory	exploratrice
Exposure	Exposition
Exposure-odds ratio	Rapport des cotes d'exposition
Exposure ratio	Rapport des proportions d'exposés
expression	expression
Expressivity	Expressivité
extemporaneous mixture	mélange extemporané
exterior ear lobe or hair just inside ear	trague
external defibrillation	défibrillation externe
external	externe
external factors	influences extérieures
External use	Usage externe
External validity	Validité externe
extracorporeal circulation or bypass	circulation extracorporelle
extracorporeal	extracorporel
extramural education	enseignement extra-universitaire
extremely important	extrêmement important
Extrinsic incubation period	Période d'incubation extrinsèque
Exudating dermal ulcer	Ulcère dermique suintant
eyeball pressure	compression des globes oculaires
Eye chart	Echelle d'acuité visuelle
eye fundus	FO
eyeground	fond d'oeil
Face-pack	Masque anti-rides
Facial skin	Peau du visage
Factor analysis	Analyse factorielle
Factor	Facteur
Factorial design	Plan factoriel
faeces	feces
failure	défaillance
failure	échec
fainting	évanouissement
fainting spell	évanouissment
fainting	voir breath-holding attack
falling off	décollement
False negative	Faux négatif
False positive	Faux positif
familial adenomatous polyposis	polypose rétro-colique familiale
Familial disease	Maladie familiale
Family centered care	assistance aux familles
Family centered care : hôpital des enfants	assistance aux familles
Family contact disease	Maladie acquise par contact familial
family leave	conge des evenements familliaux
Family study	Etude de familles
fascia	aponévrose d'enveloppe
fascia	fascia
fasciculation	fasciculation
fasciectomy	fasciectomie
fasciitis	aponévrosite
fasciography	fasciographie
fascioplasty	fascioplastie
fasciorrhaphy	fasciorraphie
fasciotomy	aponévrotomie
fasciotomy	fasciotomie
fascitis	fasciite
fast rate	vitesse rapide
Fast track surgery concept	Concept de chirugie rapide de voie
fat children	enfants obèses
fatigue	fatigue
fatigue	fatigue
fatigue fracture	fracture d'effort
fat-splitting enzyme	enzyme lipolytique
faxed or emailed results	réponses télématiques
Fc portion	fragment Fc
F depyrogenation value	Fd
F distribution	Distribution de F
Feasibility study	Etude de faisabilité
features of the normal cardiac rhythm	particularités du rythme normal
febrifuge	fébrifuge
Fecundity	Fertilité
fee caps	plafonds dhonoraires
feedback	autorégulation
feeling jittery	agitation
femoral artery	artère fémorale
femoral	fémoral
femoral hernia	hernie crurale
femoral hernia	hernie fémorale
femoral nerve	nerf crecial
femoral nerve	nerf creial
femoro-femoral	fémoro-fémoral
femur	fémur
Fermentation	Fermentation
ferritin	ferritine
Fertility	Fécondité
Fertility rate	Taux de fécondité
Fertility ratio	Ratio de fécondité
fetal alcohol syndrome	syndrome fœto-alcoolique
Fetal death certificate	Certificat de mort foetale
Fetal death	Mort foetale
Fetal death rate	Taux de mortalité foetale
fetus	foetus
fever	fièvre
fever	fièvre
fiberoptic	fibroscopie
fibre	fibre
fibrin	fibrine
fibrinogen	fibrinogène
fibroadipose	membrano-adipeux
fibroblast	fibroblaste
fibrocartilage	fibrocartilage
fibrocyte	fibrocyte
fibroid	fibrome
fibroid lung	fibrose pulmonaire
fibroids	fibromes
fibroma	fibrome
fibromyalgia	fibromyalgie
fibromyalgia syndrome	syndrome fibromyalgique
fibroscopy	fibroscopie
fibrosis	fibrose
fibrositis	fibrosite
fibrous sheath	gaine fibreuse
fibrous tissue	tissue fibreux
Field survey	Enquête sur le terrain
- Figure 15: magnetization which creates a different period length	- la figure 15 l'aimantation qui crée une période langueur différente
filling of holes	Remplissage des trous
filter	filtre
final host	hôte final
finding	découverte
findings	constatations
find the sites occupied	trouvent la place prise
fine balance	équilibre fragile
finger clubbing	hippocratisme digital
fire and rescue service	pompiers
first wave	première onde
Fisher's exact test	Test exact de Fisher
fish mouth incision	incision en bouche de poisson
fistula	fistule
fistula syringe	seringue a fistule
fit	attaque
fitting	ajustage
Fixed cohort	Cohorte fermée
fixed decay time constant	algorithme de retour préfixé
fixed tumor tissue in the paraffin blocks or fresh tumor tissue if available	tissu tumoral d'archive et tissu frais si disponible
:fixed upward gaze	plafonnement du regard
flame-shaped hemorrhage	flammèches hémorragiques
flank	flanc
flashback	flashback
flat feet	pieds plats
flatulence	ballonnements
flavoxate	flavoxate
flex dollars unused	dollars à la carte excédentaires  ???
flexible benefit plan	régime de prestations flexibles  ???
flexible plan designs	conceptions de régime flexibles  ???
flexion	flexion
floride	la flour
flow chart	graphique d'évolution
Fluconazole	Fluconazole
flu	grippe
fluorescein	fluorescéine
fluorescence endoscope	endoscope à fluorescence
Fluorescence In Situ Hybridization	FISH
fluoroscopy	fluoroscopie
fluoxetine	fluoxétine
flushing	bouffée congestive
focal	focal
focal wasting	amyotropie focale
focused	concentré
focus	effet
foetal distress	souffrance foetale
Folacin	Folacine
folate deficiency	carence en folates
folate	folates
Folic acid	Acide folique
follicular alopecia	alopécie folliculaire
Follicular hormone	Hormone folliculaire
Folliculitis	Folliculite
folliculitis	folliculite
follow-up	catamnèse
follow-up	devenir
follow-up laboratory tests	biologie de controle
follow up	suivi
Follow-up	Suivi
Fomites	Matières contaminées
food allergy	allergie alimentaire
food poisoning	intoxication alimentaire
foods	nourriture
foot doctor	podologue
footprint	empreinte plantaire
for background purposes	pour rappel
Forced expiratory volume in 1 second	FEV1
forced expired volume in one second	FEV1
Force of morbidity	Force de morbidité
Force of mortality	Force de mortalité
for clinical trial use only	à usage expérimental
foreign bodies	corps étrangers
forensic beds	lits de psychiatrie légale
Foreskin	Prépuce
formulary	formulaire
Fortuitous relationship	Relation fortuite
Fosphenytoin	Fosphénytoïne
fovea	fossette
Fox evil	Alopécie
fractured rib	côte cassée
fracture	fracture
fractures	fractures
Frænum	Frein
framework	armature
Freckles	Taches de rousseur
free drug	medicament gratuit
freely movable joint	diarthrose
Free radicals	Radicaux libres
Frequency distribution	Distribution de fréquences
Frequency	Fréquence
Frequency matching	Assortiment par fréquence
Frequency polygon	Polygone de fréquences
Frequency table	Tableau de fréquences
Frostbite	Gelure
frostbite	gelures
frozen drug formulary	formulaire des médicaments bloqués
Full blood count	FBC
functional	fonctionnelle
Function	Fonction
function	fonction
funeral director	ordonnateur de pompes funèbres
fungicial	fongicide
fungistatic	fongistatique
fungus	champignon
fungus infections	mycoses
funnel chest	thorax en entonnoir
Furoncle	Furoncle
Furonculosis	Furonculose
furuncle	furoncle
Furuncle of the nose	Furoncle du nez
fusion	fusion
fussy	agitee
gabaergic	gabaergique
Gadolinium based contrast agent	Agent de contraste à base de gadolinium
Gadolinium based contrast agents	Agents de contraste à base de gadolinium
GAF scale	échelle EGF
gait	démarche
gallbladder disease	maladie de la vésicule biliaire
gall bladder	vesiculaire
gall bladder	vesicule bilaire
gallstone	calcul biliare
gallstones	calculs biliaires
galvanic equipment	appareil galvanique
Game theory	Théorie des jeux
gametocyte	gamétocyte
Gamma-Glutamyl Transpeptidase	gammaGT
gammaGT	Gamma-Glutamyl Transpeptidase
gamma linoleic acid	acide gammalinolénique
Gamma-linolenic acid	Acide gamma linoléique
ganglion cell	cellule ganglionnaire
Ganglion cyst	Kyste ganglionnaire
ganglionectomy	gangliectomie
gangrene	gangrène
garlic	ail
gas assay	gasometric gas
gas chromatography	chromatographie gazeuse
gastrenteritis	gastro-enterite
gastritis	gastrite
gastroenteritis	gastro-entérites
gastroenterologist	gastro-entérologue
gastroenterology	gastro-entérologie
gastrointestinal bleeding	saignement gastro-intestinale
gastrointestinal	gastrointestinal
gatifloxacin	gatifloxacine
gauze	compresse
Gauze	Gaze
gauze	Gaze
Gba	glucocerebrosidase
Gefitnib	Géfitnib
Gemcitabine	Gemcitabine
Gemzar	Gemzar
Gene	Gène
gene	gène
Gene pool	Pool des gènes
general anaesthesia	AG
general anaesthesia	anesthésie générale
General anesthesia	GA
General fertility rate	Taux global de fécondité
General Social Security Centres	CGSS
Generation effect	Effet de génération
Generation time	Temps de génération
generic	générique
Genetic disease	Maladie génétique
Genetic drift	Dérive génétique
Genetic epidemiology	Epidémiologie génétique
Genetic penetrance	Pénétrance génétique
Genetics	Génétique
genetics	génétique
Genital herpes	Herpès génital
Genome	Génome
Genome map	Carte du génome
genome-wide linkage studies	étude globale du génome par analyse de liaison
genomics	génomique
genu valgum	genu valgum
genu varum	genu varum
Geographic pathology	Pathologie géographique
Geometric mean	Moyenne géométrique
geriatrician	gériatre
geriatrics	gériatrie
germ cell	cellule germinative
germ cell	cellule reproductive
Germ-free	Stérile
gerontology	gérontologie
Gestational age	Age gestationnel
gestational age	l'âge gestationnel
gestational diabetes	diabète gesttione
gestodene	gestodène
ghost cell	cellule dépigmentée
ginkgo biloba	ginkgo biloba
girdle	ceinture
gland	glande
Glandular extracts	Extraits glandulaires
glandular fever	mononucleose
glans of penis	gland
glaucoma	glaucome
glaucommatous	glaucomateuses
glenoid	glénoïde
glioblastoma	glioblastome
glioma	gliome
Global medical device nomenclature code	Code GMDN
Glomerular filtration rate	GFR
Glomerular filtration rate	Taux de filtration glomérulaire
Glomerulus	Glomérule
glucocerebrosidase	Gba
glucocorticoid	glucocorticoïde
glucosamine hydrochloride	chlorhydrate de glucosamine
glucose	glucose
glucuronide	glucuronide
glutamic oxalacetic transaminase	GOT
glutamic pyruvic transaminase	GPT
glycosaminoglycans	glycosaminoglycanes
goat anti-human immunoglobins	solution à base d'immunogloulines ...
going around the right hand side of...	en contournant du coté droit
goiter	goitre
golden seal	hydraste du canada
Gompertz's law	Loi de Gompertz
Gonococcus	gonocoque
Gonodotrophic cycle	Cycle gonodotrophique
gonorrhoea	blennorragie
good air entry	Good air entry
good effect	effet bénéfique
Goodness of fit	Ajustement statistique
Goodness of fit test	Test d'ajustement statistique
goose-neck	col de cygne
gout	goutte
gout	goutteuses
Gradient of infection	Gradient de l'infection
Gram-negative bacillus	GNB
gram-negative	gram-négatif
gram-positive	gram-positif
Grans.	Granulocytes
granulocyte	granulocyte
Granulocytes	Grans.
grapefruit pip extract	extrait de pépins de pamplemousse
grape seed extract	extrait de pépin de raisin
Graph	Graphique
Gravidity	Gravidité
gravity abscess	abcès par congestion
greater omentum	grand épiploon
greater overall protection	protection totale plus importante
greater peritoneal sac	grande cavité péritonéale
Great saphenous vein	GSV
Green hylid	La Rainette Verte
greenstick fracture	fracture en bois vert
grepafloxacine	grépafloxacine
griping	colique
groin	aine
groove	fente
Gross reproduction rate	Taux brut de reproduction
Growth chart	Toise
growth	croissance
growth-onset diabetes	diabète juvénile
Growth rate of population	Taux d'accroissement de la population
Growth studies	Etudes de croissance
grunting	geingenement expiratoire
Guaranteed issue	Montant garanti à la souscription
guideline	directives
Guidelines	recommandations
guidewire	fil-guide
guiding catheter	cathéter-guide
gum	gencive
gumma	gomme
gynecology	gynécologie
gynecomastia	gynecomastie
Hackett spleen classification	Classification des splénomégalies par dimension
Hæmangioma	Hémangiome
Haematidrosis	Hématidrose
Hæmatoma	Hématome
haemodynamic	hémodynamique
haemolytic anaemia	anémie hémolytique
haemorrhage	hémorragie
haemorrhoids	hémorroïdes
Hair Ache	problemes de cheveux
hair bulb	bulbe pileux
hair extensions	rallonage de cheveux
Hair follicle	Follicule pileux
hair follicle	follicule pileux
Hairiness	Villosité
hair matrix cells	cellules de la matrice pilaire
hair wire	fil de cheveux
half-life	demi-vie
hallux valgus	hallux valgus
Halo effect	Effet de halo
Handicap	Handicap
handicapped children	enfants handicapés
handling	manipulation
Handover form	fiche de liaison
hangover	gueule de bois
Hantavirus	Hantavirus
Haphazard sample	Echantillon tout venant
hard and soft drusen	les drusen dures et molles
Hard data	Données dures
hard	induré
hardness	dureté
Hardy-Weinberg law	Loi de Hardy-Weinberg
Harelip	Bec de lièvre
Harmonic mean	Moyenne harmonique
Haversian canal	canal de Havers
hawthorn	aubépine
headache	céphalée
Head and Neck Unit	unité céphalique
head injury	traumatisme crânien
Head lice	Poux de tête
health and safety	hygiene et securite
Health behavior	Comportement de santé
Health care	Soins de santé
Health education	Education sanitaire
Health index	Indice de santé
Health indicator	Indicateur de santé
Health professional	Professionnel de la santé
Health promotion	Promotion de la santé
Health	Santé
Health services research	Recherche sur les services de santé
Health services	Services de santé
Health statistics	Statistiques sanitaires
Health status index	Indice de l'état de santé
Health survey	Enquête de santé
Health & Welfare Canada	Santé et Bien-Être Canada
healthy	en bonne santé
healthy tissue	tissus sains
Healthy worker effect	Effet de la bonne santé des travailleurs
hearburn	priposis
hearing aid	auditive
Hearing Aid Practitioner	audioprothésiste
hearing	audition
heart attack	crise cardiaque
heartburn	brûlures destomac
heart	cœur
heart	coeur
heart disease	cardiopathie
heart disease	maladie cardiaque
heart failure	arrêt du coeur
heart monitoring device	moniteur cardiaque
heart problems	accidents cardiaques
heart rate	fréquence cardiaque
Heart rate	HR
Heart rate monitor	Moniteur de fréquence cardiaque
heart rate	rythme cardiaque
heat	chaleur
heat failure	arrêt du cœur
Hebdomadal mortality rate	Taux de mortalité néonatale précoce
heel	talon
helmet	casque
help	aider
hemangioma	hémangiome
hemarthrosis	hémarthrose
hematemesis	hématémèse
hematological	hématologique
hematology	hématologie
hematoma	hématome
hematomas	hematomes
hematopoiesis	hematopoïèse
Hematuria	Hématurie
hematuria	hématurie
hemiarthroplasty	hémiarthroplastie
hemiation	herNiation - hérnie
hemochromatosis	hemochromatose
Hemodialysis blood line	Tubulure artério-veineuse
hemodialysis	hémodialyse
hemolysis	hemolyse
hemolysis	hémolyse
hemopericardium	hémopéricarde
hemoperitoneum	hémopéritoine
Hemophilia A	hémophilie A
hemopoietic	hématopoïétique
hemoptysis	hémoptysie
hemorrhagic stroke	Attaque dapoplexie hémorragique
hemostasis	hémostase
hemothorax	hémothorax
Henle-Koch postulates	Postulats d'Henle-Koch
Henle's loop	Anse de Henle
Heparin	Héparine
heparin	héparine
heparinised	hépariné
heparinize	hépariniser
hepatic	hépatique
Hepatitis A	Hépatite A
Hepatitis B	Hépatite B
Hepatitis B Virus	HBV
Hepatitis Cvirus	HCV
hepatitis	hepatite
hepatitis	hépatites
Herd imunity	Immunité collective
hereditary	héréditaire
heredity	hérédité
hernia	hernie
herniated disc	discale hernie
hernioplasty	hernioplastie
herniorrhaphy	herniorraphie
herniotomy	herniotomie
Herpes	Herpès
herpes zoster	herpès zoster
Herpes zoster	Zona
Heterogenous	Hétérogène
Heteroscedasticity	Hétéroscédasticité
heuristic	heuristique
hexadecasaccharide	hexadecasaccharide
hiatal hernia	hernie hiatale
Hibernation	Hibernation
Hibernia deposition gauge type collector	collecteur de précipitations de type jauge Hibernia.
high blood pressure	hypertension
higher-order reference materials	matériaux de référence supérieurs
high fever	forte fievre
high risk pregnancy	grosesse a risque eleve
high spike in blood pressure	poussées hypertensives.
hip	hanche
hip joint	articulation de la hanche
hip replacement surgery	chirurgie de remplacement de la hanche
hirsutism	hirsutisme
hirudin	hirudine
Histogram	Histogramme
histology	histologie
histone deacetylase	histone déacétylase
histopathological	histopathologique
Histoplasma farciminosum	Histoplasma farciminosum
Histoplasma	Histoplasma
Historical cohort study	Etude de cohorte rétrospective
Historical control	Etude de cohorte historique
history	antecedent
History	History
hives	urticaire
hiv	Virus de l'immunodéficience humaine
hmo	entretien de santé
hoarseness	enrouement
Hodgkins disease	maladie dHodgkin
Hogben number	Témoin historique
Holoendemic disease	Maladie holoendémique
Holomiantic infection	Infection de source commune
home care	soins à domicile
Home care	Soins à domicile
home health	aide a domicile
home nursing care	soins infirmiers à domicile
Homeostasis	Homéostasie
homocysteine	homocystéine
homocystinuria	homocystinurie
Homoscedasticity	Homoscédasticité
hood	cagoule
hook wire localisation	Repérage par harpon
hormonal therapy	hormonothérapie
hormone-dependant	hormono-dépendant
hormone	hormone
hormone like	analogue d'hormone
Hormone replacement therapy products	Traitements hormonaux de substitution
Hormone replacement therapy	Traitement hormonal de substitution
Hospital-acquired infection	Hôte
Hospital discharge abstract system	Système de résumés de notes à la sortie de l'hôpital
hospital	hôpital
Hospital separation	Infection nosocomiale Infection acquise à l'hôpital
host	hôte
hot flashes	bouffées de chaleur
hot flushes	bouffées de chaleur
hot flushes	chaleurs
hourglass head	crâne en sablier
Hour	hr
Household	Enquête sur un échantillon de ménages
Household sample survey	Indice hématophage
housekeeping gene	gène ménager OU gène constitutif
Human blood index	Ecologie humaine
human growth hormone	hormone de croissance
humanized	humanisé
human specimens supplied in duplicate	22 paires d'échantillons humains codés
humeroulnar joint	articulation huméro-cubitale
humerus	humérus
Huntington's chorea	chorée de Huntington
Huy Regional Medical Center	HRMC
hyaline cartilage	cartilage hyalin
hyaluronic acid	acide hyaluronique
hyasthenia gravis	myasthenie gravis
Hycamtin	Hycamtin
hydrarthrosis	hydrarthrose
Hydration	Hydratation
hydrochloride	hydrocholure
hydrocortisone	hydrocortisone
hydrogenated vegetable oils	huiles végétales hydrogénées
hydrothorax	hydrothorax
hydroxyapatite	hydroxy-apatite
Hydroxychloroquine	Hydroxychloroquine
hydroxy	hydroxy
hydroxymethyl	hydroxyméthyl
Hygiene	Hygiène
hyperactivity	hyperactivité
hypercalcemia	hypercalcémie
hyperemia	hyperémie
Hypergeometric distribution	Distribution hypergéométrique
hyperglycaemia	hyperglycémie
Hyperkalemia	Hyperkaliémie
hyperostosis	hyperostose
Hyperparathyroidism	Hyperparathyroïdisme
Hyperphosphatemia	Hyperphosphatémie
hyperplasia	hyperplasie
hypertension	hypertension
hyperthyroidism	hyperthyroïdie
hypertonic	hypertonique
hyperventilation	hyperventilation
hypervolemia	hypervolémie
hypnosis	hypnose
hypnotic	hypnotique
hypocholesterolemic	hypocholestérolémiant
hypochondriac region	hypocondre
Hypodermis	Hypoderme
hypoechogenic area	plage absorbante
hypoesthesia	hypoesthésie
hypogastric region	hypogastre
hypoglycaemia	hypoglycémie
hypoglycaemia secondary to glyburide	Hypoglycémie documentée secondaire au traitement de glyburide
hypoglycaemic	hypoglycémiant
hypokalemia	hypokaliémie
hypoplasia	hypoplasie
hypotension	hypotension
hypotensive	hypotendu
hypothermia	hypothermie
Hypothesis	Hypothèse
Hypothesis testing	Test d'hypothèse
hypothyroidism	hypothyroïdie
hypoventilation	hyporespiration
hysterectomised	hystérectomisée
I am not delusional.	Je ne suis pas délirant
Iatrogenic disease	Maladie provoquée par le traitement médical Maladie iatrogène
ibs	troube intenstinale
ibs	troubles intestinale
Iceberg phenomenon	Phénomène de l'iceberg
ice pack	sachet de glace
idiopathic anisomastia	anisomasthie idiopathique
Idiosyncrasy	Idiosyncrasie
if the indication is only from	si seul un essai clinique de l'ins. glar. vient étayer cette indication
I hereby authorise X to pass on the results of my blood test to	j'autorise X à transmettre au besoin les resultats de mon prélèvement sanguin
ileal and pancolonic	iléo-pancolique
ileitis	iléite
iliac arteries	artères iliaques
iliac extension	extension iliaque
ill	malade
Illness behaviour	Comportement lié à la maladie
illness	maladie
Illness	Maladie
image intensifier	amplificateur d'image
imaginary lines	lignes imaginaires
immmuno-suppression	immuno-depression
Immunization	Immunisation
immunological determinations	analyses immunologiques
impacted fracture	fracture engrenée
Impact	Impact
impaction	enclavement
impaired glucose tolerance	tolerance de defiecit de glucose
impaired nerve connective tissues flexibility	diminution de souplesse du tissu conjonctif nerveux
Impairment	Déficience
impairment	gêne
impairment of nerve function	dysfonction neurologique
Impetigo	Impétigo
impingement	conflit
implantable defibrillator	défibrillateur implantable
implant	appareil acoustique
implant female	boîtier femelle
impose a life-long contraindication	contre indique à vie
impossible to trigger or modify	non mobilisable ni modulable
improvement	amélioration
impulsiveness	impulsivité
inactivation of enzymes	désactivation d'enzymes
in adults and older children	grand enfant
in an average week	au cours d'une semaine type
in and out of control on warfarin	soumis ou non à la warfarine
Inapparent infection	Infection inapparente
Inception rate	Fréquence de nouveaux épisodes de maladie
Incidence density	Densité d'incidence
Incidence	Incidence
incidence of further chest pain	incidence de nouveaux épisodes de douleurs thoraciques
Incidence rate	Taux d'incidence
Incidence study	Etude d'incidence
Incident number	Nombre de nouveaux cas
incipient	débutant
incipient form	forme débutante
incipient gangrene	début de gangrène
including MCO public healthcare centers	y compris les centres des organismes de gestion des soins de santé publique
including the samples	encadrant les echantillons
Income Tax Act of Canada	Loi de limpôt sur le revenu du Canada
incomplete fracture	fracture incomplète
in consideration of the foregoing	en contrepartie de ce qui precede
increase	augmentation
Incubation period	Période d'incubation
incus	enclume
Independence	Indépendance
Independent events	Evénements indépendants
Independent variable	Variable indépendante
in development	en cours de développement
Index group	Groupe index
Indicator variable	Variable indicatrice
Indirect adjustment	Ajustement indirect
Individual variation	Variation individuelle
induc labor	provoquer l'accouchement
induction heat seal membrane	opercule thermosoudé par induction
Induction period	Période d'induction
Industrial hygiene	Hygiène industrielle
in exchange for procedures and undesirable events..	en contrepartie de procédures et d'événements indésirables
Infectibility	Susceptibilité à l'infection
infection	infection
Infection	Infection
Infectious disease	Maladie infectieuse
infectious diseases	maladies infectieuses
Infectious diseases	Maladies infectieuses
Infectiousness	Contagiosité
Infectivity	Infectivité
Inference	Inférence
Infestation	Infestation
inflamed	enflammé
inflate	gonfler
inflation	gonflage
inflation	gonflement
influenza	rhume
Information system	Système d'information
Informed consent	Consentement éclairé
infusion	perfusion
ingredient	constituant
Ingrown nail	Ongle incarné
inguinal hernia	hernie inguinale
inguinal node	ganglion inguinal
inhalant anaesthetic	anesthésique par inhalation
initial dosis	dose d'attaque
initiate	inaugurer
injuries	dommages
injury	blessure
innovative treatment	traitement novateur
Inoculation	Inoculation
inorganic luminescent material	matériau luminescent inorganique
in patient	hospitalisé
Insect bite	Piqûre d'insecte
insect bites	piqûres dinsectes
in segment 3	en C3
insertion aponeurosis	aponévrose d'insertion
in space	dans lespace
Instantaneous incidence rate	Taux d'incidence instantanée
Instrumental error	Erreur liée à l'instrument
instrument	instrument
Insulin-requiring	IR
insult	accident
insurance	assécurologie
insurance	assurance
integumentary appendages	annexes tégumentaires
Intended duration of treatement	Durée prévue du traitement
intensive care	réanimation
Intensive care unit	ICU
Interaction	Interaction
Interceptive orthodontics	Orthodontie modificatrice
intercondylar distance	distance intercondylienne
interfaced to an automated lab system	couplé à une système automatisé de tests en labo
interferes with contraction	trouble la contraction
interim analysis	analyse intermédiaire
Interleukin	Interleukin
intermediate host	hôte intermédiaire
Intermediate variable	Variable intermédiaire
Internal validity	Validité interne
International comparison	Comparaison internationale
International units	IU
International Vaccination Record	carnet de vaccinations international
interstial cystitis	intersite cystitie
interstital cystitis	interstital cystite
interuterine device	sterolet
Interval incidence density	Densité d'incidence dans l'intervalle entre deux examens
Interval scale	Echelle par intervalle
Intervening cause	Cause intermédiaire
Intervening variable	Variable intermédiaire
Intervention study	Etude d'intervention
Interventricular septum	IVS
intervertebral cartilages	disques intervertébraux
intervertebral disk	disque intervertébral
Interview schedule	Plan d'entrevue
in the field of	dans le domaine de
in the presence of two reporting judges	en double rapporteur
in the spiral groove	à la gouttière de torsion
intimal tear	déchirure de l'intima
intra-aortic balloon pump	IABP
intractable angina	angine rebelle
intractable pain	douleur récalcitrante
intragluteally	dans le muscle fessier
intrahepatic bile duct cancers	cholangiocarcinomes intra-hépatiques
intra-medullary interlocked stem	tige de fixation intramédullaire
Intramolecular	Intramoléculaire
intraocular pressure	la pression intraoculaire
intrascleral space	espace intrascleriale
intrauterine device	stérilet
intravenous infusion sets	perfusites
intricate	Compte tenu de la complexité de l'architecture artério-veineuse de ce patient...
introducer sheath	gaine de protection
introducer sheath	gaine d'introducteur
introducer sheath	gaine d'introduction
invasion	envahissement
inverted T opening	ouverture en T inversé
investing cartilage	cartilage de revêtement
investment aponeurosis	aponévrose de revêtement
Involuntary smoking	Fumer involontairement Inhalation involontaire de la fumée de tabac
involved	impliqué
involve	frapper
iodine excess	surcharge iodé
ipsilateral	homolatéral
iron clinics	consultations fer
iron deficiency anemia	frriprive
irreversible condition	état irréversible
is a valued addition to	prendre toute sa place
ischemic stroke	accident ischémique cérébral
is concentrated	cette étude a pour objectif premier
is intended to	est destiné à
is just about maintained but with straining until the knee is extended	à peu près tenue mais en forte tension jusqu'au maintien du genou en extension
Island population	Population Ólienne
isolation	Isolement
Isometric chart	Graphique isométrique
is transmitted	se propage
Itchiness	Démangeaison
itching	démangeaisons
itching	prurit
iud	sterilité
iv drip	poche a perfusion
iv	intraveneux
Japanese B Encephalitis	Encéphalite japonaise B
jaundice	jaunisse
jealousy	jalousie
jet lag	décalage horaire
joint capsule	capsule articulaire
joints	articulations
J-tip	en J
J-tip wire	fil-guide en J
Judkinss left	JL
Kappa	Mesure d'accord Kappa
karyolysis	caryolyse
karyorrhexis	caryorrhexie
keloid	chéloïde
Kendall's tau	Tau de Kendall
Kent bundle	faisceau de Kent
keratinocyte	kératinocyte
Keratosis	Kératose
ketone bodies	corps cétoniques
ketone	cétone
key object	KO
kidney bed	loges rénales
kidney cancer	cancer du rein
kidney disease	maladie des reins
kidney disease	maladie du rein
Kidney failure	Insuffisance rénale
kidney	le rein
kidney stone	le calcul renal
kidney stones	calculs rénaux
kidney stones	calculs renaux
kidney stones	calcus rénaux
kidney trouble	troubles du rein
kinase insert region	site d'insertion des kinases
kinetic	cinétique
kit	trousse
knee brace	genouillère
knee joint	articulation du genou
knock-knee	genou cagneux
knock knee	genou en X
Koch's postulates	Postulats de Koch
kyphosis	cyphose
labelled	étiqueté
labia minora nymphes	petites lèvres
laboratory diagnostic	diagnostic biologique
laboratory findings	tableau biologique
labor-inducing agent	agent inducteur du travail
lab value	Voir ci-dessous
Lack	Carence
lactate dehydrogenase	LD
lactate dehydrogenase	LDH
lactic bacteria	bactéries lactiques
lactose free	lactose - intolerant
lacuna	lacune
lacunar	lacunaire
lameness	courbature
Langerhansian adenoma	adénome insulaire
lap count	compresses pour laparotomie
larger joints	grosses articulations
Large sample method	Méthode basée sur de grands échantillons Méthode asymptotique
laryngeal cartilages	cartilages du larynx
laryngitis	laryngites
latch on	s'accrocher
Late neonatal mortality rate	Taux de mortalité néonatale tardive
Latent immunization	Immunisation latente
Latent infection	Infection latente
Latent period	Période de latence
latex	emulsion
Latin square	Carré latin
latissimus dorsi muscle	grand dorsal
law line	renseignements juridiques en ligne
laxative	Laxatif
lay back	couchez-vous
layer	assise
lay-off	chômage technique
leads	sondes
Lead time bias	Biais lié au temps de devancement
Lead time	Temps de devancement
leaflet	notice
Least squares	Moindre carré
Leflunomide	Léflunomide
Left anterior descending	LAD
Left atrium	LA
left atrium	'OG - oreillete gauche
left carotid	carotide gauche
Left femoral artery	LFA
Left radial artery	LRA
Left Ventricle Ejection Fraction	LVEF
Left ventricle	LV
Left ventricular end diastolic diameter	LVEDD
Left Ventricular End-Diastolic Pressure	LVEDP
left ventricular end systolic  and end diastolic volume	Les volumes télésystolique et télédiastolique ventriculaires gauches
Left ventricular failure	LVF
Left ventricular hypertrophy	LVH
legal assistance program	programme dassistance juridique
legal reparation of physical injury	reparation legale d'inury physique
leg compression	compression jambière
lense	le zoom
Lesion	Lésion
less-invasive care for some of life's most threatening medical conditions.	une large gamme de produits et services permettant ....
Lethality	Létalité
letting a loss of bone substance continue	laissant persister une perte de substance osseuse
leukaemia	leucémie
leukemia	leucemie
level	niveau
level one tests	analyses de premier niveau
licence to practise	compétence ordinale
Life events	Evénements de la vie
Life expectancy at a given age	Espérance de vie à un âge donné
Life expectancy at birth	Espérance de vie à la naissance
Life expectancy	Espérance de vie
Life style	Style de vie
life sustaining drug	médicament essentiel au maintien de la vie
Life table	Table de survie
life-threatening	engageant le pronostic vital
Lifetime risk	Risque cumulé pendant la vie entière
Likelihood function	Fonction de vraisemblance
Likelihood ratio test	Test du rapport des maximums de vraisemblance
like shitasu	doin
Limited Benefit Clause	Clause limitant létendue des prestations
limited use drug	médicament à utilisation restreinte
Linear model	Modèle linéaire
Linear regression	Régression linéaire
linoleic acid	acide linoléique
lip balm	pommade pour les levres
lipid-enriched cleansing bar	pain surgras
Lipid	Lipide
lip piercing	piercing a la levre
lipping	becs de perroquet
liquid ounce	once liquide
Liquid soap	Savon liquide
listening therapy	thérapie découte
Live birth	Naissance vivante
liver disease	maladie de foie
liver disease	maladie du foie
liver	foie
liver function tests	exploration fonctionnelle hépatique
liver or kidney failure	disfonctionnement du foie ou du rein
Local allergic reaction	Réaction allergique locale
local anaesthesia	anesthésie locale
Local edema	Oedème local
localized areas that cause delay in activation of the myocardium	des zones qui laissent mal se propager les impulsions
Local management	Traitement local
Loculi	loges
Locus	Locus
Logistic model	Modèle logistique
Logit	Logit
Logit model	Modèle du logit
Log-linear model	Modèle log-linéaire
Log-normal distribution	Distribution log-normale
lometpos	cinetose
Longitudinal study	Etude longitudinale
Long Procotol Dosing	Protocole long
Long-term ailment	LTA
Long term booster immune memory	réactivation de l'immunité mémoire à long terme par un rappel
long-term	de longue durée
Loop of Henle	Anse de Henle
loose consciousness	conscience desserré
loosening	descellement
loss-in-weight	dépesée
loss of balance	perte d'équilibre
loss of consciousness	Perte de connaissance
loss of sex-drive	baisse de la libido
low anterior resection	résection antérieure basse
low back pain	douleurs de la région lombaire
low back pain	douleurs du bas du dos
Low birth weight	Poids faible à la naissance
low blood sugar	hypoglycémie
low-calorie	hypocalorique
low energy	faible énergie
lower back pain	douleur lombalgies
lower extremity pain	douleurs des membres inférieurs
Lower left limb	LLL
Lower limbs	LL
lower limbs	membres inférieurs
lower limbs	membres inferieurs
Lower right limb	LRL
Low Molecular Weight Heparin	héparine de bas poids moléculaire
Low molecular weight heparin	LMWH
low porosity	faible porosité
low sperm count	spermicoide
low sperm	oespermie
low thyroid function	hypothyroïdie
L-tryptophan	L-tryptophane
lumbar	lumbaire
lumbar puncture	ponction lombaire
lumbar support belt	ceinture de maintien lombaire
lumber ribs	Please read : Lumbar ribs
lumbosacral fusion	arthrodèse lombo-sacrée
Lumbosacral Radiculopathy	radiculopatie lombaire et sacree
lump	bosse
lung abscess	abcès pulmonaire
lung cancer	cancer du poumon
lung clots	embolie pulmonaire
lung disease	maladie pulmonaire
lung	le poumon
lungs	poumons
Lung Volume Reduction Coil	Coil de réduction du volume pulmonaire
lunotriquetral interval	intervalle luno-pyramidal
lyme disease	maladie de Lyme
lymph capillary	capillaire lymphatique
lymph node capsule	capsule ganglionnaire
lymph nodule	follicule lymphatique
lymphoid follicle	follicule lymphoïde
Lymphoma	Lymphome
lymphoproliferative malignancies	tumeurs lymphoprolifératives
Macrophage	Macrophage
Macular eruption	Éruption maculaire
Macule	Macule
Madelung's deformity	carpocyphose
magnesium citrate	citrate de magnésium
mail order pharmacy	système de pharmacie par correspondance
maintenance and platform storage	manutention et mise sur terre-plein
maintenance dose	dose d'entretien
Malaria endemicity	Endémicité du paludisme
malaria	paludisme
Malaria patent period	Période de parasitémie paludéenne
Malaria periodicity	Périodicité du paludisme
Malaria reproduction rate	Transmission paludéenne en zone non impaludée
Malaria survey	Enquête sur le paludisme
male menopause	andropause
male-pattern alopecia	alopécie hippocratique
male-pattern alopecia	alopécie séborrhéique masculine
male pattern baldness remedy	remèdes pour la calvitie masculine
Malignant melanoma	Mélanome malin
malignant skin cancer	cancer malin de la peau
mameography	mameographie
mammal	mammifère
Mammary eczema	Eczéma mammaire
Mammary implant	Implant mammaire
Mammary	Mammaire
mammary ridge	crêtes mammaires
Mammary tissue	Tissu mammaire
mamogram	mamographie
managed care formulary	formulaire de soins cogérés
Management	Management
management of neuropathic pain	gestion des douleurs liées aux neuropathies
mandibular cartilage	cartilage de Meckel
Manifestational variable	Variable dépendante
manipulation	arthrocinèse
Mantel-Haenszel estimate	Estimation de Mantel-Haenszel
Mantel-Haenszel odds ratio	Rapport des cotes de Mantel-Haenszel
Mantel-Haenszel test	Test de Mantel-Haenszel
manufacturer	fabricant
many causes	causes multiples
marginal branch of left coronary artery	marginale artérielle
marginal branch of left coronary artery	marginale gauche
marginal branch of left coronary artery	première marginale
Margin of safety	Marge de sécurité
market sensing	sensibilité au marché
Markov process	ChaÓne de Markov
Mass screening	Dépistage de masse
mastitis carcinosa	mastite carcinomateuse
masturbation	masturbation
Matched controls	Témoins assortis
Matching	Assortiment
Maternal death	Décès maternel
Mathematical model	Modèle mathématique
mating	accouplement
max allowable rate of increase per time	En une fois
maximum allowed fee	honoraires professionnels maximums admissibles
Maximum likelihood estimate	Estimation selon le maximum de vraisemblance
maximum rolling dollar limit	le remboursement total maximal en dollars ??
Maximum saturated carboxylation rate	Cmax
McNemar's test	Test de McNemar
meals	repas
mealtimes	heures des repas
mean corpuscular hemoglobin concentration	C.C.M.H.
mean corpuscular volume	MCV
mean platelet volume - MPV	volume plaquettaire moyen - VPM or VPLM
Mean pre-dose FEV1	VEMS pré-dose moyen
measles	rougeole
Measles	Rougeole
measles	rubeole
Measurement	Mesure
Measurement scale	Echelle de mesure
Measure of agreement	Mesure d'accord
Measure of association	Mesure d'association
Measure of dispersion	Mesure de dispersion
Measure of frequency	Mesure de fréquence
Measure of impact	Mesure d'impact
Measure of interaction	Mesure d'interaction
Measures of central tendency	Mesure de tendance centrale
Measuring psoriasis	évaluation du psoriasis
mechanical lavage	lavage mécanique
Mechanical transmission	Transmission mécanique
Median	Médiane
mediated by	médié par
mediated dUTP nick-end labeling staining	méthode TUNEL
Medical advice	Avis médical
Medical audit	Audit médical
Medical care	Soins médicaux
medical device	dispositifs médicaux
medical devices	des dispositifs médicaux
medical history	antécédents médicaux
medical illness	affection
medical oncology	cancérologie médicale
Medical record	Dossier médical
Medical statistics	Statistiques médicales
medical ultrasound community	le monde de l'échographie médicale
medical underwriter	tarificateur de risques médicaux
Medical Underwriting Dept.	Service de souscription médicale
medication administration route	Voie dadministration
medicinal products	produits pharmaceutiques
Medicines Act	loi sur les médicaments
medigap policy	police écart
medium spectrum antibiotics	antibiotique à spectre moyen
meibomian cyst	chalazion
meibomian gland	glande de Meibomius
Melanin	Mélanine
Melanoma	Mélanome
melanoma	mélanome
mellitus diabetes	diabete sucré
melolabial fold	pli nasolabial
membrane filtration process	traitement de type membranaire
Mendel's law	Lois de Mendel
menisous	menisque
menopause	ménopause
mental activity	activité mentale
mental deficiency	déficience mentale
Mental Health	Santé mentale
mesenteric artery	artère mésentérique
Meta-analysis	Méta-analyse
metabolism	métabolisme
metal backed	avec renforcement métallique
metaphyseal dysostosis	dysostose métaphysaire
metaphysis chondrodysplasia	chondrodysplasie métaphysaire
Metastatic melanoma	Mélanome métastatique
Methodology	Méthodologie
method sheet	feuille de procédures
Methylphenidate	Méthylphénidate
Metoclopramide	Métoclopramide
Miasma theory	Théorie des miasmes
Mibefradil Dihydrochloride	Mibéfradil dichlorhydrate
microculture plate	culture cellulaire sur microplaque
micro-organism	germe
mid portion of the hepatic pedicle	partie moyenne du pédicule hépatique
Mifepristone	Mifepristone
migraine	migraine
Migrant studies	Etudes de populations migrantes
mild	bénin
mild	discret
mild ICU delirium	delirium des soins
Mild skin irritation	Irritation cutanée
milk	lait
Mill's canons	Lois de Mill
Minimum data set	Ensemble minimal de données
Minor abrasion	Lésion mineure
Minor burn	Brûlure superficielle
Minor calyx	Calice mineur
minor cartilages	cartilages accessoires
minor cartilages	cartilages sésamoïdes
Misclassification	Classification erronée
Misoprostol	Misoprostol
missed menses	absence de règles
mistaken diagnosis	erreur de diagnostic
misuse	emploi abusif
Mites	Acariens
Mitosis	Mitose
mitral regurgitation	fuites auriculaires
mobile dosing services	unité mobile de distribution de traitement de substitution
mock drill	exercice de simulation
Model Code for the Protection of Personal Information	Code type sur la protection des renseignements personnels  ???
Model	Modèle
Mode	Mode
mode of onset	mode de survenue
moderate	modéré
moderate to severe chronic shift work sleep disorder	troubles modérés à sévères de l'endormissement
Moderator variable	Variable modifiante
Modification	Modification
modified apocrine glands	glandes apocrines modifiées
Moisturizing cream	Crème hydratante
Moisturizing emulsion	Emulsion hydratante
monitoring	contrôle
Monitoring	Monitorage
mono or strep	mononucléose ou streptocoque
monophasic E wave	Onde E exclusive
Monotonic sequence	Suite monotone
mood	humeur
Morbidity	Morbidité
Morbidity rate	Taux de morbidité
Morbidity survey	Enquête de morbidité
morphine sulfate	MS direct
Mortality rate	Taux de mortalité
Mortality statistics	Statistiques de mortalité
Most active drug	Médicament plus actif
most likely to choose	le plus disposé à choisir
mother cell	cellule mère
motor examination	examen moteur
motor impairment	déficit moteur
motor neuron diseaswe	maladie de neurone moteur
motor system	appareil moteur
Motor vehicle accident	MVA
mouth wash	collutoire
mucinosis	alopécie mucineuse de Pinkus
mucous plug	bouchon muqueux
mucuous sheath	gaine séreuse
muffled	etouffe
Multicollinearity	Co-linéarité multiple
Multidisciplinary Intensive Care Unit	Service de réanimation polyvalente
multidisciplinary meeting	RCP
Multifactorial etiology	Etiologie multifactorielle
multi-focal lens implants	implants cornéens à foyer progressif
Multinomial distribution	Distribution multinomiale
Multiphasic screening	Dépistage multiphasique
Multiple causation	Etiologie multifactorielle
Multiple logistic model	Modèle de régression logistique
multiple procedural drugs	Il s'agit de nécessaires ou kits pour anesthésie épidurale ou
Multiple regression	Régression multiple
Multiple risk	Multiples facteurs de risque
multiple sclerosis	sclérose en plaque
multiple tumours	tumeurs multiples
Multiplex families	Familles multiplexes
Multiplicative model	Modèle multiplicatif
Multiresistant bacteria	MRB
Multistage model	Modèle multistade
Multivariate analysis	Analyse multivariée
mumps	oreillons
murmur	souffle de coeur
muscle cell	cellule musculaire
muscle disorders	troubles musculaires
muscle fatigue or strain	fatigue musculaire
muscle relaxant	relaxant musculaire
muscle spasm	spasme musculaire
muscle spasms	spasmes musculaires
muscle strain	tension de muscle
muscle wasting	atrophie musculaire
muscular disease	affection musculaire
muscular dysstrophy	dystrophie musculaire
muscular fibre	fibre musculaire
muscular pain	douleurs musculaires
Mutation	Mutation
Mutation rate	Taux de mutation
Mutually exclusive classes	Classes mutuellement exclusives
myalgia	douleur musculaire
My co-pay is too high	ticket modérateur ou franchise
myelinated axon	axone myélinisé
myelin sheath	gaine de myéline
myeloproliferative	myéloprolifératif
myelosuppression	dépression médullaire
myelosuppression	insuffisance médullaire
Myocardial infarction	MI
myocardial ischaemia	ischémie myocardique
myocardial ischemia	MI
myodegeneration	dégénérescence musculaire
myodystrophy	dystrophie musculaire
myofascopathy	douleur myofasciale
myofibroma	fibromyome
myotrophy	amyothrophie
naevus	naevus
nail biting	habitude de se ronger les ongles
nail groove	gouttière unguéale
Nail	Ongle
named-patient programme	ATU nominative
naming	Dénomination
narrow QRS complexes	complexes QRS fins
nasal cartilages	cartilages du nez
National Pricing Policy	politique nationale de fixation des prix
Natural history of disease	Expérimentation naturelle
Natural history study	Histoire naturelle de la maladie
Nausea	NAUSEE
Necessary and sufficient cause	Méthode du voisin le plus proche
neck brace	orthèse cervicale rigide
neck	collet
necrosis of the heart muscle	nécrose du muscle
needle	aiguille
Needs	Cause nécessaire et suffisante
Nefazodone	Néfazodone
nef reading frame	cadre de lecture complet de la protéine nef
negative enrollment	condition dadhésion négative
Neonatal mortality rate	Besoins
Neonatal period	Taux de mortalité néonatale
Nephrectomy	Néphrectomie
nephritis	nephrite
Nephrolithiasis	Néphrolithiase
nephrologist	nephrologue
Nephrology	Néphrologie
nephrostomy tract	trajet de néphrostomie
nerve cell	cellule nerveuse
nerve fibre	fibre nerveuse
nerve tract	faisceau nerveux
nervous system	système nerveux
Nested case control study	Période néonatale
Net migration	Etude cas-témoins au sein d'une cohorte
Net migration rate	Migration nette
Net reproduction rate	Taux net de migration
netrofil inhibitor factor	nif
Nettle-rash	Urticaire
neuritis	neurirte
neurodiagnostic  electrodes non disposable	électrode neurodiagnostique non jetable
neurogenic	d'origine nerveuse
neuroglia cell	cellule névroglique
neurological deficit	déficit neurologique
neurological examination	examen neurologique
neuromuscular blocking agent	curare
neuropathic pain	douleurs d'origine nerveuse
neutron beam	faisceau de neutrons
newborn	nouveau-né
New York Heart Association	NYHA
next generation sequencing	séquencage de prochaine génération
Niacin	Niacine ou vitamine B3
night feeds	repas de nuit
nightlight	veilleuse
nightmares	cauchemars
night terrors	terreurs nocturnes
nipple	mamelon
nitrates	dérivés nitrés
Nits	Lentes
nocturnal confusion	confusion nocturne
node	ganglion
no detectable blast cells	pas de cellules d'aspect blastique
no imaging evidence	sans traduction TEMP-TDM en regard
Nomenclature	Nomenclature
Nominal scale	Echelle nominale
Nomogram	Nomogramme
Nonconcurrent study	Etude de cohorte historique Etude de cohorte rétrospective
Nondifferential misclassification	Erreur de classification non différentielle
non-haemorrhagic neurological event	accident neurologique
Non-insulin-dependent diabetes	NIDD
non-osteogenic fibroma	fibrome non ostéogénique
Nonparametric methods	Méthodes non paramétriques
Nonparametric test	Test non paramétrique
non-pyrogenic	apyrogène
non-responding apneas	apnées réfractaires
normal behaviour	comportement normal
normal bradycardia	bradycardie naturelle
Normal breath sounds	NBS
Normal distribution	Distribution normale
normal laboratory values	constantes biologiques
Normal limits	Limites normales
normal pressure hydrocephalus	hydrocéphalie à pression normale
Normal skin	Peau normale
Normal value	nv
Norm	Norme
normothermia	normothermie
nose spray	pulverisateur
nosey cup	verre decoupe pour le nez
Nosocomial infection	Infection acquise à l'hôpital - infection nosocomiale
no specific apical involvement	sans atteinte élective apicale
Nothing to report	NTR
Notifiable disease	Maladie à déclaration obligatoire
No traumatic bone lesion	NTBL
no treatment failure	pas d'échappement
no trophic or motor function changes in the right lower limb	point de trophicité ou de motricité du MID
Not yet discharged as of:	Toujours présent le:
Not yet discharged as of:	Toujours présent le
no-win situations	impasse
N-terminally truncated fragments and the influence of this cleavage on the funct	fragments tronqués en N-terminal et troncature pour cleavage
Nuclear Magnetic Resonance	NMR
nuclear research reactor	réacteur de recherche nucléaire
nucleic acid	acide nucléique
Null hypothesis	Hypothèse nulle
number of atrial impulses conducted to the ventricles	nombre dimpulsions transmises
numbness	engourdissement
Numerator	Numérateur
Numerical taxonomy	Taxinomie numérique
nurse practioner	infirmier practicien
nursing mother	mère allaitante
nutritional elements	éléments nutritifs
oats	avoine
obesity	obésité
Obliterating Arteriopathy of the Lower Limbs	OALL
OBrien-Fleming type boundary at a 1-sided cumulative 2.5% level of significance	frontière de type O'Brien et Fleming
Observational study	Etude d'observation
obsessive-compulsive behaviour	comportement compulsif -obsessif
obstruction	occlusion intestinale
obstructive sleep apnea	apnée obstructive du sommeil
Obstructive sleep apnea syndrome	OSAS
obturator	calibreur
occlusal equilibration	équilibrage docclusion
Occlusion of the middle third of the RCA in a non-dominant RCA	Occlusion CD 2 sur CD dominée médicale
occult blood	hemmoragie occulte
occult blood	hemorragie occulte
occupational dermatitis	dermatite professionnelle
occupational therapist	therapie de maladie professionelle
occupational therapy	ergothérapeute
occupational therapy	érgothérapie
Occupation	Santé au travail
occupy the receptor sites	se fixent sur les sites
ocular disease	maladie oculaire
Odds	Cote
Oedema	Oedème
off-label	hors indication
off-label indication	indication hors AMM
of reproductive age	en âge de procréer
Ointment acne	Acné à la vaseline
Ointment	Pommade
oleic acid	acide oléique
oligosaccharide	oligosaccharide
Oliguria	Oligurie
on average	en moyenne
on-board capacity	capacité de chargement
oncologue	oncologist
one-step dosing	Littéralement : administration en une fois
One-tail test	Test de signification unilatéral
Online Administration Services	Services administratifs en ligne
On-line real time drug utilization review	Examen de la consommation pharmaceutique en direct et en temps réel
on the assumption of maximum reimbursement	dans l'hypothèse maximaliste
onychectomy	ablation d'un ongle
Open-ended question	Question ouverte
Open formulary	Formulaire des médicaments acceptés
open-label study or trial	essai ouvert
open surgery	chirurgie sanglante
open surgical technique	mise à plat greffe
Operational research	Recherche opérationnelle
operation	fonctionnement
Operations research	Recherche opérationnelle
operative dependencies	ses unités et services
Opportunistic infection	Infection opportuniste
opposing mechanisms of action	mécanismes d'action contradictoires ou antagonistes
oral antibiotics	antibiotiques per os
Oral antidiabetics	OAD
oral capsule	capsule par voie orale
oral contraceptive	contraceptif oral
oral contraceptives	contraceptifs oraux
oral liquid	buvable
orange peel effect	peau d'orange
orders that execution of the sentence of imprisonment be suspended	ordonne qu'il sera sursis à l'exécution de la peine d'emprisonnement
Ordinal scale	Echelle ordinale
Ordinance on requirements concerning medicinal products	OÉmed
Ordinate	Ordonnée
oriented by a suture	orientée par un fil
original	d'origine
originating in the atria	oreillettes en cause
Osmosis	Osmose
osteitis	ostéites
osteoarthritis of hip	coxarthrose
osteoarthritis of the knee	gonarthrose
osteoarthritis	ostéoarthrite
osteogenesis imperfecta	fragilité osseuse constitutionnelle
osteogenic fibroma	fibrome ostéogénique
osteomyelitis	osteomyelite
osteoporosis	ostéoporose
osteotendinous reflexes	reflexes ostéo-tendineux
ostial disease	pathologie ostiale
otitis media	otite moyenne aiguë
outbreak	flambée
outbreak of sweat	hypersudation
Outcome variable	Variable dépendante
Outgrowth	Excroissance
outline of benefits	description des prestations
outpatient	consultant externe
out patient	malade ambulatoire
outpatient physician coverage	couverture des soins médicaux ambulatoires
outpatient's treatment	traitement de sortie
outpatient study	étude en ambulatoire
outpout	débit
ovarian cancer	cancer de lovaire
ovarian cancer	cancer de l'ovaire
ovarian	ovariènne
oveitis	ov`eites
Overactive Bladder	Vessie hyperactive
over-activity	excès d'activité
over and above	en plus de
overdenture	prothèse hybride
Overdose	Surdosage
Overestimation	Surestimation
overlying loops	superposition des anses intestinales
overnight stay	séjour de nuit
overpricing	surfacturation
overt	franc
over-the-counter drugs	médicaments en vente libre approuvés
Over The Counter	OTC
over the counter	sans ordonnance
over use	depassement
oxygen deprivation	manque doxygène
pacing device	stimulateur  cardiaque
pacing therapies	cardiostimulation ...
package	emballage
pack-year	PY
pacquet liver	foie ficelé
pad	compresse
paddles	palpateuse
pain clinic	centre anti-douleur
pain	douleur
Pain	Douleur
pain	douleur
painful	douloureux
pain killer	antalgique
Pain reliever	Analgésique
paired-eye comparison study	Etude comparative exploratoire multicentique versus placebo sur 6 mois ...
Paired samples	Echantillons appariés
Pairing	Appariement
palate	palais
pale-faced	blemies
palmar fascia	aponévrose palmaire
palmitic acid	acide palmitique
palpation over the facet joints of mid cervical region	palpation en regard des massifs antérieurs de la région cervicale moyenne
palpebral	palpébral
palsy	paralysie
pancreatic cancer	cancer du pancréas
pancreatitis	pancreatite
pancreatitis	pancréatite
pantothenic acid	acide pantothénique
Paradigm	Paradigme
paradigms or models of domains involved	Les paradigmes des disciplines mobilisées
paralyzed	paralize
Parameter	Paramètre
Parametric test	Test paramétrique
paranasal sinus surgery	chirurgie des sinus paranasaux
paraplegia	parapléegie
Parasite count	Décompte des parasites
Parasite density	Densité des parasites
Parasite	Parasite
parasites	symphilisme
Paratenic host	Hôte intermédiaire d'un parasite
parathyroid glands	parathyroide glandulaire
Parenchyma	Parenchyme
parenchyma	parenchyme
parental 1012 DNA vaccine	souche parentale 1012
paresis	parésie
parietal pericardium	feuillet pariétal du péricarde
Parity	Parité
Parkinson's disease	madie de Parkinson
partial colour blindness	fausse perception des couleurs
partial thickness incision	incision d'épaisseur partielle
Participant in the public hospital service	PPHS
Particularisation	Particularisation
partitioning	partage
Passage	Passage
Passenger variable	Variable dépendante concomitante
Passive smoking	Fumer involontairement
Passport to Health™	Passport to Health™
patch	timbre
patellar bursa	bourse pré-rotulienne
patellofemoral	fémoro-patellaire
patency	béance
Patent Act	Loi sur les brevets
Patent Protection Law	Loi sur la protection par brevet
Path analysis	Analyse des réseaux
Pathogenesis	Pathogenèse ou pathogénie
pathogenic bacteria	bactéries pathogènes
Pathogenicity	Pathogénicité
Pathogen	Pathogène
pathogens	agent pathogène
pathological changes	altérations pathologiques
pathway	Filière
pathway	parcours
pathway	trajet
patient bleep	alerte patient
Patient ID number	PIN
patient	malade
patient pathway	parcours du patient
patient record book	carnet de liaison
patient reportings	comptes rendus de patients
patients with histologically documented advanced or recurrent	voir explication
pattern	aspect
pattern	disposition
pavement cell	cellule pavimenteuse
payable by the patient	mis á charge du patient
payor	les organismes payeurs
PDE5 Inhibitor	Inhibiteur de la PDE5
PDE5 Inhibitors	Inhibiteurs de la PDE5
Peak Expiratory Flow Time PEFT	Débit expiratoire de pointe
peak flow	flux culminant
peak kilovoltage	valeurs de tension de crête en kilovolts
Peak systolic velocity	PSV
Pearson's product moment correlation	Coefficient de corrélation de Pearson
pectoral girdle	ceinture scapulaire
pectoral girdle	ceinture thoracique
pedal oedema	oedème du pied
pedial pulse	Pouls pédieux
pedicle graft	greffon pédiculé
pedicle walls	'les parois du pédicule'
pediculate	pédiculé
Pedigree	Pedigree
Peer review	Revue par les pairs
pelivc	pelvien
pelvic cavities	cavités pelviennes
pelvic floor muscle group	chaînes sous-pelviennes
pelvic girdle	ceinture pelvienne
pelvic inflammatory disease	maladie incendiaire pelvienne
pelvic	pelvien
Penetrance	Pénétrance
Penicillin resistant staphylococci	Staphylocoques résistants à la pénicilline
pentaerytrityltetranicotinate	nicéritrol ou tétranicotinate de pentaérythrityle
People are under the extremely seriously mistaken impression	tout le monde croit à tort que
peptic	pepsique
peptic ulcer	ulcere digestif
Perceived need	Besoin perÁu
Percentile	Percentile
percutaneous transluminal coronary angioplasty	angioplastie coronarienne percutanée transluminale
percutaneous transluminal coronary angioplasty	PTCA
perequisite	condition sine qua non
perforation of the ear drum	signe de l'oreille
performance evaluation	évaluation de performance
performance monitor	moniteur de performance
performed by cervicotomy	réalisée par cervicotomie
perfused	perfusé
pericardial cavity	cavité péricardique
Pericarditis	Péricardite
perigraft leak	fuite périprothétique
Perimetry indices	Critères périmétriques
perinatal mortality	mortalité périnatale
Perinatal mortality	Mortalité périnatale
Perinatal mortality rate	Taux de mortalité périnatale
Perinatal period	Période périnatale
Perineal anus	Anus périnéal
perineural fibrosis	remaniement fibrovasculaire périnerveux
Period of communicability	Période de transmissibilité
Perirenal fat	Graisse périrénale
peritoneal abscess	abcès péritonéal
Peritoneal dialysis	Dialyse péritonéale
Peritoneum	Péritoine
peritonism	péritonisme
periurethral bulking agents	agents de comblement urétral
permanent changes	altérations définitives
permanent changes	altérations permanentes
pernicious anemia	pernicieux anemie
Personal health care	Soins de santé individuels
Personal hygiene	Hygiène intime
Personal Information Protection & Electronic Documents Act	Loi sur la protection des renseignements personnels et les documents électroniques
Personal monitoring device	Equipement de monitorage individuel
personal support worker	travailleur de soutien personnel
Person-time at risk	Personne-temps à risque
Person-time	Personne-temps
Person-to-person spread of disease	Transmission de la maladie de personne à personne
Person-years	Personnes-années
Perspiration	Transpiration
Perte de connaissance - loss of consciousness	PC
perversion	pervertissement
Petri dish	boîte de Pétri
petty cash	fonds de caisse
Phamaceutical White Oil WP 60	Emulsion WP 60
pharmaceutical and chemical companies	l'industrie pharmaco-chimique
Pharmaceutical Microbiology unit	Unité de Pharmaco-microbiologie
Pharmacoepidemiology	Pharmacoépidémiologie
Pharmacy Benefit Management System	système de gestion des prestations pour pharmacie
Pharmacy on-line adjudication system	système en direct de règlement des demandes avec les pharmacies
phase II study	étude de phase II
Phentermine	Phentermine
Phenylpropanolamine	Phénylpropanolamine
Phenylpropanolamine	Phénylpropanolamine ou noréphédrine
Phenytoin	Phénytoïne
phial	ampoule
phials to be taken orally	ampoules buvables
phlebitis	phlébite
phosphodiesterase inhibitor	inhibiteur de la phosphodiestérase
Photo-aging	Photo-vieillissement
Photochromic	Photochromique
photogreymd	lentille photochromatique
Photosensitisation	Photosensibilisation
Photosensitive rash	Eruption photosensible
Photosensitivity	Photosensibilité
physical activity	activité physique
physical and neurological examination	examen physique et neurologique
physical chemistry	physico-chimie
physically demanding	pénibilité
physical therapy	physiotherapie
physician performing the procedure	médecin réalisateur
pick up your treatment plan.	prendre votre gestion
Picornaviridae	picornaviridés
Pie chart	Diagramme en secteurs
Pigment	Pigment
pilary canal	canal pilaire
pilary gland	glande pilaire
Pilary	Pilaire
Pill	Pilule
pilo-erection	horripilation
pilosebaceous canal	canal pilo-sébacé
pilosis	hirsutisme
Pilosity	Pilosité
pin	broche
pinched nerve	nerf pincé
pins or hooks	tuber ischii ou tuber coxae
pins	tiges
pituitary gland	hypophyse glande
placenta covering	barrière placentaire
Place of birth	Lieu de naissance
place stresses	fatiguer
Plain abdominal x-ray	PAX
PlanProtect	Protect-régime
Plantar reflex	PR
plasma half life	hémi-vie du plasma
plaster cast	appareil plâtré
plaster jacket	corset platré
platelet aggregation	agrégation plaquettaire
platelet count	numération formule plaquettaire
platelets	plaquettes
platinum agent	dérivé du platine
pleural cavities	cavités pleurales
pleural effusion	épanchement pleural
pleural endothelioma	endothélium pleural
pleurisy	pleurésie
plex	Plex
plug	bouchon
pneumonia	pneumonie
pocket card	aide-mémoire
Point source epidemic	Epidémie de source ponctuelle
Poisson distribution	Distribution de Poisson
polio vaccination	vaccin anti-poliomyélitique
Pollution	Pollution
polyarticular gout	goutte polyarticulaire
polycistic kidney disease	maladie poloyskique de reins
polycystic kidney disease	maladie de rein polycystic
Polycystic kidney disease	Polykystose rénale
Polygenic inheritance	Transmission héréditaire polygénique
polymastia	polymastie
polymyositis	polymyosite
polythelia	polythélie
Ponderal index	Indice pondéral
Pontage artere interventriculaire antérieure	PIVA
pooled urine	Urines de 24 heures
poor nutrition	malnutrition
Population at risk	Population à risque
Population excess rate	Taux en excès dans la population
Population medicine	Médecine de population
Population momentum	Potentiel d'accroissement de la population
Population	Population
Population pyramid	Pyramide de la population
positive enrollment	condition dadhésion positive
possible increased responsiveness	possibilté de sensibilité augmentée au myorelaxant
post-concussion	commotion tranatisme
Posterior probability	Probabilité a posteriori
Posterior wall	PW
post-market drug safety & effectiveness	innocuité et efficacité des médicaments
postmarketing experience	Ce sont les deux.
Postmarketing surveillance	Surveillance après vente
post-menopausal women	femmes ménopausées
postmortem examination	examen post-mortem
Postneonatal mortality rate	Taux de mortalité post-néonatale
post-prandial plasma glucose level	niveau de glycémie veineuse post-prandiale
post traumatic syndrome	syndrome de stress post-traumatique
posture	attitude
posture	maintien
potassium ions	ions K
Pott's fracture	fracture de Dupuytren
potty	pot de chambre
pouch	cul-de-sac
pounding heartbeats	les palpitations
powdered milk	lait en poudre
power-propelled drive system	système d'entraînement mécanique
Power	Puissance
Pragmatic study	Etude pragmatique
PRBCs	culots globulaires
pre-adressed mailer	enveloppe pré-adressée
preaortic lymph node	ganglion pré aortico pulmonaire
Precancerous melanosis of Dubreuilh	Mélanose circonscrite
Precision	Précision
preclampsia	eclampsisme
precluding	empêchant
Precursor	Précurseur
Predictive value of a negative test	Valeur prédictive d'un test négatif
Predictive value of a positive test	Valeur prédictive d'un test positif
Predictive value	Valeur prédictive
predisposing factor	facteur prédisposant
pre-eclampsia	pré-eclampsia
preexcitation syndrome	syndrome de pré-excitation
preferential uptake	captage préférentiel
pregnancy	grossesse
Pregnancy	Grossesse
pregnancy	grossesse
pregnant	enceinte
premenstrual pain	douleurs prémenstruelles
Premium Group and Individual Health and Dental Benefits Specialist	Le grand spécialiste en prestations collectives et individuelles des soins de santé et dentaires au Canada
Premunition	Prémunition
prepared	techniqué
presbyacusia	presbiacousié
pre-school child	enfant d'âge pré-scolaire
prescribed	pr'escrit
Prescription Drug Special Authorization Form	Formulaire dautorisation spéciale de médicament dordonnance
prescription period	delai de prescription
prescription refill	renouvellement d'ordonnance
Prescriptive screening	Prévalence
present airway obstruction	obstruction bronchique objectivée
preservation	conservation
press any key to continue	appuyez sur une touche pour continuer
press-fit	ajusté en force
pressure on nerves	tension nerveuse
pre-term baby	prématuré
Prevalence	Prévalence relative
Prevalence rate	Rapport de prévalences
Prevalence study	Etude de prévalence
Preventable fraction	Fraction évitable
Prevented fraction	Fraction évitée
Prevention	Prévention
Preventive medicine	Médecine préventive
Preventive trial	Essai préventif
Primary case	Cas primaire
Primary health care	Soins de santé primaires Soins de première ligne
primary study	recherche originale
Principal component analysis	Analyse en composantes principales
Prior probability	Probabilité a priori
Probability density	Densité de probabilités
Probability distribution	Distribution de probabilités
Probability	Probabilité
Probability sample	Echantillon aléatoire ou probabiliste
Probability theory	Théorie de probabilités
probe	approfondir
probe	examiner
probe	sonde
problems concentrating	difficultés de concentration
procedure	acte
procedure	chirogie
procedure	déroulement
procedure	geste
procedure	modalité
processing	Lindépendance des traitements de lidentité faciale et de lexpression émotionnelle
processing	transformation
proctology	proctologie
Product dossier	dossier de fabrication
product profile	fiche de présentation du produit
profiling	profilage
Program	Programme
Program review	Revue de programmes
Program trial	Evaluation expérimentale ou quasi-expérimentale d'un programme
Prolene purse-string suture	Bourse de prolène
proliferative pseudosarcomatous fascitis	fasciite nodulaire pseudo-sarcomateuse
Properties of anticancer drugs targeting oncogenes	Propriété des molécules anticancéreuses oncogénétiques
Proportional hazards model	Modèle de régression à effet proportionnel
Proportionate mortality rate	Taux de mortalité proportionnelle
Proportionate mortality ratio	Ratio de mortalités proportionnelles
Proportion	Proportion
Propoxyphene	Propoxyphène
proprietary name	Nom de spécialité
prosatatis	prostatie
proselytisme	proselitysm
prospective cure	traitement expérimental
Prospective study	Etude prospective
prostate specific antigen	prostate antigène spécifique
prostatitis	prostatite
prosthetic Y-shaped bypass graft	PONTAGE EN Y PROTHÉTIQUE
protective effect	effet protecteur
protein	protéines
Proteinuria	Protéinurie
Proteoglycanes	Protéoglycanes
Prothrombin level	PL
Protocol Champion	Chef de protocole
Protocol	Protocole
protwine stain	angiome plan
Provider Online Services	Services au fournisseur en ligne
provincial compounding fee	Frais provinciaux pour les composés
provisional and final diagnosis	diagnostic provisoire et definitif
Proximal convoluted tubule	Tube contourné proximal
proximal	en amont de
proximal end	extrémité proximale
Proximal interphalangeal joint	PIPJ
proximal to	En amont de la palette
Proximal tubule	Tube proximal
proximal ureteral and pyelocalyceal dilatation	dilatation urétéro-pyélocalicielle damont
Proximate determinant of fertility	Facteurs qui influencent directement la fécondité
Pruritis ani	Prurit anal
Pruritis scroti	Prurit scrotal
Pruritis vulvae	Prurit vulvaire
Psoriasis	Psoriasis
psychological counseling	conseils psychologiques
ptosis	ptose
Pubic pressure urinal	urinal à pression sus-pubienne
Public company	PC
Public Health	Santé publique
pudendal nerve	nerf honteux
puffiness	bouffissure
Pulmonary hypertension	PHT
Pulsatility index	PI
pulselessness	abolition du pouls
pulse oximeter techniques	techniques d'oxymétrie pulsée
pulse	pouls
pumping breasts	tireuse électrique
punch biopsy	biopsie à l'emporte-pièce
Punch card	Carte perforée
punishment	punitions
Purkinje cell	cellule de Purkinje
purpose	but
purposes	objectifs
Purpura	Purpura
purpura	purpura
Pus	Pus
Pustular	Pustulaire
Pustule	Pustule
put on a drip	ÇáÍÞä ÈÇáãÍÇáíá Úä ØÑíÞ ÇáæÑíÏ
P wave	onde P
pyramidal cell	cellule pyramidale
Pyrrolizidine Alkaloids	Alcaloïdes pyrrolizidiniques
QRS complex	complexe QRS
QRS snapshot	Instantanée QRS
qualification as an orthoptist	capacité d'orthopiste
Qualitative data	Données qualitatives
Quality control	Contrôle de la qualité
Quality of care	Qualité des soins
Quality of life	Qualité de vie
Quantiles	Quantiles
Quantitative data	Données quantitatives
Quarantine	Quarantaine
Quasi-experiment	Quasi-expérimentation
Questionnaire	Questionnaire
Quetelet's index	Indice de Quételet Indice de masse corporelle
queuing model	modele file d'attente
quiet operate iris port	Hublots à diaphragme silencieux ou à manipulation silencieuse
Quota sampling	Echantillonnage par quotas
Quotient	Quotient
Race	Race
radiation monitoring meter	appareil de mesure des radiations
radiofrequency  RF	radiofréquence  RF
radioscopic C-arm	arceau de scopie
radiotherapy	radiotherapie
radiotherapy	radiothérapie
radioulnar joint	articulation radio-cubitale
Radix	Table hypothétique d'une cohorte de naissance
Rahe-Holmes social readjustment rating scale	Echelle d'évaluation de réajustement social de Rahe-Holmes
Raloxifene	Raloxifène
random access	accès aléatoire
Random error	Erreur aléatoire
Randomization	Allocation aléatoire Randomisation Allocation au hasard
Randomization is blocked by site	La randomisation s'effectue par centre avec stratification en fonction de ...
randomized clinical trial	distribution aléatoire des sujets dans les groupes comparés
Random sample	Echantillon aléatoire
randomtest	contrôle aléatoire
Range of distribution	Etendue de la distribution
Ranking scale	Echelle ordinale
Rapacuronium Bromide	Bromure de rapacuronium
Rapid Infusion Catheter	Cathéter pour perfusion rapide
rashes	éruptions
Raskin E chart	E de Raskin
Rated client	Client à prime fixe
Rate & Economic Analyst	spécialiste en taux et économie - analyste actuariel
Rate-odds ratio	Rapport de cotes de maladie
Rate	Taux
rating	évaluation
Ratio scale	Echelle proportionnelle
raw ulcer	ulcération ouverte
Raw weeping area	Lésion à vif suintante
reabsorption coefficient	coefficient de résorption
reading	lecture
real and permanent death	mort réelle et constante
real time	en temps réel
reamer	alésoir
reasonable	acceptable
Reasonable suspicion testing	tests de dépistage de substances illicites en cas de doute raisonnable
recent blood transfusion	transfusion sanguine récente
reciprocating tachycardias	tachycardies réciproques
reconstructive surgery	chirurgie reconstructrice
Recontouring	plastie
recovery	guérison
recovery	réanimation
Recrudescence	Recrudescence
rectal bleeding	saignement de rectum
rectouterine pouch	cul-de-sac recto-vaginal
rectovesical pouch	cul-de-sac vésico-rectal
recurrent indigestion	indegestion recurrénte
recurrent	récidivant
red blood cells	globules rouges
Red blood cells	RBC
red cell	globule rouge
Redness	Rougeur
re-excision	reprise
referal	renvoie
reference lumen area	aire de référence
Reference population	Population de référence
refers to	correspond
refill	remplir de nouveau
refill	reremplissable
Refinement	Raffinement
reflected	recourbé
réflexes ostéo-tendineux or symmetrical deep tendon reflex	ROT symétriques
Reflux nephropathy	Néphropathie du reflux
refractive cells	cellules réfringeantes
Refractory period	RP
regimen	rythme d'administration
Registered General Nurse	Infirmier Breveté Généraliste
registrar	chef de clinique
Registration	Enregistrement
Regression analysis	Analyse de régression
Regression line	Droite de régression
Regression	Régression
Relative odds	Rapport de cotes
relaxation	décontraction
relax	détendre
releasing factor	hormone libérante
relevant clinically actionable	pertinents cliniquement exploitable
Reliability	Fiabilité
reline impression	empreinte d'alignement
removal	ablation
removal	exérèse
renal arteries	artères rénales
Renal biopsy	Biopsie rénale
Renal cortex	Cortex rénal
renal damage	atteinte rénale
renal disorder	désordre renal
Renal failure	Insuffisance rénale
Renal insufficiency	Insuffisance rénale
Renal lobe	Lobe rénal
Renal medulla	Médulla rénale
Renal papilla	Papille rénale
renal pelvis	bassinet rénal
Renal tubule	Tubule rénal ou tubule urinifère
rental lease	bail
reorder	recommander
Repeatability	Reproductibilité
repeated cardioplegia	cardioplégie itérative
repetitive strain injury	repitiion de fouler un muscle
Replacement level fertility	Taux de reproduction
repolarization	repolarisation
Representative sample	Echantillon représentatif
Reproducibility	Reproductibilité
reproductive hormones	hormones reproductrices
Reproductive isolation	Endogamie
reproductive organ	organe reproducteur
request for 100% reimbursement	demande de 100%
resection of the entire mid-body and posterior horn of the meniscus	résection de toute la corne moyenne et postérieure méniscale
reserves costs	réserve les dépens
Reservoir of infection	Réservoir de l'infection
Residual volume	RV
Resolution	Résolution
Resolving power	Pouvoir de discrimination
respiratory system	appareil respiratoire
respiratoy infection	infection respiratoire
response-count	nombre de réponse
response curve	courbe de réponse
Response rate	Taux de réponse
response strategies	pistes de solution
responsive secondary haematopoiesis	hématopoïèse réactionnelle
resting EEG	EEG au repos
resting gated-SPECT	Tomographie SPECT synchronisée à l'ECG au repos
restless baby	bébé sans cesse en mouvements
Rest	Repos
resuscitation	réanimation
retention suture	suture de renforcement
reticular fibre	fibre réticulaire
reticular fibre	fibre réticulée
reticular layer	couche réticulaire
Retrograde cystography	Cystographie rétrograde
Retroperitoneum	Rétropéritoine
retrospective chart review	analyse rétrospective des dossiers médicaux
Retrospective study	Etude rétrospective
Retrovirus	Rétrovirus
retroxiphoid	Rétraxyphoïdien
reversible changes	altérations réversibles
rewards	récompenses
rheumatic fever	Fièvre rhumatismale
rheumatism	deformation
rheumatoid arthritis	arthrite rheumatoide
rheumotologist	rheumotologue
rib	côte
Riboflavin	Riboflavine ou vitamine B2
ribs	côtes
rickets	rachitisme
riding embolus	embol à cheval
Right anterior oblique	RAO
right atrium	oreillette droite
Right atrium	RA
right carotid	carotide droite
Right coronary	RC
right hypochondrium	RHC
right lymphatic duct	grande veine lymphatique
right subclavian	en sc dte
Right ventricle	RV
rigid lumbar brace	corset de contention
rim	jante
ring	anneau
ringworm	dermatophytose
ringworm	teigneux
Risk assessment	Evaluation du risque
Risk benefit analysis	Analyse risques avantages
Risk benefit ratio	Rapport risques avantages
Risk difference	Différence des risques
Risk factor	Facteur de risque
Risk Factors	RF
Risk management	Management des risques
Risk ratio	Rapport de risques
risks and safety statements	S'il s'agit bien de la NOTICE d'un médicament : voir ci-dessous
robustness of hazards to adjustment	la robustesse des risques relatifs après ajustement
Robust	Robuste
rod	batonet
rod	Tige
roentgen diagnosis	diagnostic radiologique
Rolling months	Mois consécutifs - reportés
roll up and unroll	enroulent et déroulent
roman catholic	catholique romaine
root canal	canal dentaire
root canal	canal radicalaire
Roseola	Roséole
rotator cuff	coiffe des rotateurs
rotator cup	rotateur blessure de blanchette
Route of administration	Voie dadministration
routine tempus	éprouvettes Tempus habituelles
rubella	rubeolle
rubella	rubicelle
Rubric	Rubrique
runs	clichés
saddle joint	articulation en selle
safe and sound	se sentir en  sécurité
safety alarm	avertisseur de securite
Safety factor	Facteur de sécurité
safety limits	limites en matière de sécurité
Safety standards	Normes de sécurité
salvage therapy	sauvetage
salvage treatment	traitement de rattrapage
sample	échantillon
Sample	Echantillon
sample for product release testing	échantillon libératoire
Sample size	Taille de l'échantillon
Sampling	Echantillonnage
Sampling error	Erreur d'échantillonnage
Sanitary cordon	Cordon sanitaire
saphenofemoral junction	Crosse SI
Saphenous vein graft	SVG
sapwood	aubier
Sarcocele	Sarcocèle
Sarcotic	Sarcotique
Scabies	Gale
scaffolded arterial segment	segment artériel stenté
Scale	Echelle
scalp	cheveleux
scalp	chevelu
Scalp dermatitis	Dermatite du cuir chevelu
Scaly crust	Croûte squameuse
Scan	scintigramme
Scar	Cicatrice
scar	cicatrice
Scarface	Balafre
scarlet fever	scarlatine
Scarlet	Scarlatine
scar tightness	retraction de la cicatrice
Scatter diagram	Diagramme de dispersion
schedular	céedulaire
Scholarship Program for Dependents	Programme de bourses détude pour personnes à charge
Schwann's sheath	gaine de Schwann
scout and pilot images	clichés de repérage et de centrage
scratch	egratignure
scratch	égratignure
scrawny	famalique
screaming	hurlement
Screening Criteria	Critère de sélection
Screening	Dépistage
screening enzymatic tests	réactions enzymatiques d'orientation
Screening level	Niveau de dépistage
sealed	fermé
seasonal allergies	allergies saisonnières
Seasonal variation	Variation saisonnière
sebaceous gland	glande sébacée
Seborrhea	Séborrhée
seborrheic alopecia	alopécie séborrhéique
Seborrheic dermatitis	Dermatite séborrhéique
Seborrheic	Séborrhéique
seborrhoeic dermatitis	séborrhée
Secondary attack rate	Taux d'attaque secondaire
secondary phenomenon	phenomene d'accompagnement
second-degree AV block	bloc de second degré
Second degree burn	Brûlure du deuxième degré
second-line	deuxième intention
secretory phase	phase estroprogestative
Secular trend	Tendance séculaire
sedation	sédation
sedative	calmant
seed graft	greffe par implantation
seesaw murmur	bruit de va-et-vient
segmental bone loss of the middle cranial base	pertes de substances interruptrices de létage moyen.
seizures	convulsions
seizures	crise d'épilepsie
seizures	crises convulsifs
Selection bias	Biais de sélection
Selection	Sélection
selective and specific inhibitor of the sinus node If current	inhibiteur sélectif et spécifique du canal If au niveau du noeud sinusal
self-expanding	expansible
self-report	auto-rapport
Self-selection	Auto-sélection
self-testing	autodiagnostic
sender-receiver	expediteur-receptionnaire
Senile pruritus	Prurit sénile
Senior Doctor	SD
Sensitive skin	Peau fragile
Sensitivity and specificity	Sensibilité et spécificité
Sensitivity testing	Cas sentinelle
sensor	capteur
sensory impairement	déficit sensoriel
sensory system	appareil sensoriel
Sentinel physician	Médecin sentinelle
Sentinel practice	Clientèle médicale sentinelle
Sepsis probably due to bacterial translocation from the gastrointestinal tract	sepsis par probable translocation à un point de depart digestif.
sequelae	séquelles
sequence	séquence
Sequential analysis	Analyse séquentielle
Serendipity	Découverte inattendue et heureuse
series of images	serie de coupes
serious ciliary dyskinesia	dyskinésie ciliaire secondaire
serious deformity	difformité sévère
serious	grave
Seroepidemiology	Séroépidémiologie
serum globulin	globuline sérique
Serum	Sérum
sesamoid ligament complex	sangle sésamoïdienne
severe at the root of the mesentery	marquée à la racine
severe frontal headaches	les cephalées hyperalgiques en casque
severe hepatic cytolysis	cytolyse hépatique majeure
severity of their symptoms	gravité de leurs symptômes
Sex ratio	Ratio des sexes
Sex-specific rate	Taux par sexe
sexually transmitted disease	maladie sexuellement transmissible
sexually transmitted disease	venereal disease
sexual swellings	Tuméfaction de la région génito-anale  - Ne pas oublier que la logique cartésienne exige en FR que le génito passe avant l'anal.
sharp glass	verre tranchant
sheath	gaine
shelf life	durée de conservation
Shelf life	Durée de stabilité
shelf life	durée de stabilité
sherrif	sherif
shin	devant du tibia
shingles	bardeaux
shingles	zona
shingle	zona
shipment	expédition
shipyard	chantier naval
Shoe-leather epidemiology	Epidémiologie sur le terrain
shorter menstrual cycle	cycles raccourcis
short sampling	échantillon insuffisant pour l'examen
Short-term memory	Mémoire immédiate
shoulder arthroplasty	arthroplastie de l'épaule
shoulder joint	articulation scapulo-humérale
shrug	haussement d'épaules
shy children	enfants timides
Sibship	Fratrie
Sibutramine	Sibutramine
sickel cell disease	dépranocytose
sickle cell anemia	drépanocytose
sickle cell	depranocyte
sickle cell disease	anémie falciforme
sickle cell	hématie falciforme
Sickness	Maladie
sicle cell anemia	anemie depraocytose
side effect	effet secondaire
Side effect	Effet secondaire
signaling in developpment	signalisation développementale
Significant	Paradoxe de Simpson
Simpson's paradox	Simulation
Simulation	Analyse de situation
simultaneous mode	choc bidirectionnel
single dose vial	flacon monodose
single mode	choc unidirectionnel
single-parent family	parent unique
sinus bradycardia	bradycardie sinusale
sinus infection	infection des sinus
sinus pause	pause sinusale
sinus rhythm	rythme sinusal
sinus tachycardia	tachycardie sinusale
site	foyer
site	zone lombaire siège
Sitting disease	pathologie de la posture assise
Situation analysis	Distribution asymétrique
size	format
skeletal chondromatosis	chondromatose du squelette
Skew distribution	Virus lent
Skin abrasion	Ecorchure
skin cancer	cancer de la peau
Skin cleansing	Hygiène cutanée
Skin closure	Sutture cutanée
skin disorders	affections de la peau
Skin disorder	Trouble de la peau
skin graft	greffe cutanée
skin	peau
Skin reaction	Réaction cutanée
Skin vulnerability	Fragilisation de la peau
skull	crâne
slashing and gouging wounds	lacérations ou plaies profondes
slice	coupe
sliding hernia	hernie par glissement
slightly loosen locking knobs	desserrez légèrement les boulons de serrage
sloughing	formation d'escarres
slow blood flow	débit sanguin
Slow virus	Habitudes de fumer
slurred speech	altération de la parole
slurring	empatement
small cavities	micro-lacunaire
small cell lung cancer	cancer du poumon à petites cellules
Small Group Product	Produit pour petites entreprises
small intestine	intestin grêle
small renal pelvis outside the renal sinus	petit bassinet extra-sinusal
Smear	Frottis
smell	hume
Smoking habits	Classe sociale
smoking	tabagisme
smoldering myeloma	myélome dormant
snap back into a panhandle structure	réadopter spontanément une structure en queue de poêle
Soap	Savon
so-called	dite de cohorte
Social class	Dérive sociale
Social drift	Médecine sociale
Social dysfunction and social disability	Préjudice détablissement
Social medicine	Classification socio-économique
Socioeconomic classification	Statut socio-économique
sodium ascorbate	ascorbate de sodium
sodium ions	ions Na
Sodium usniate	Usnate de sodium
soft diet	régime de consistance molle
soft tissue	parties charnues
Solar acne	Acné solaire
Solvent	Solvant
some people	certaines personnes
sore throat	mal à la gorge
Soundex code	Source d'infection
Source of infection	Coefficient de corrélation des rangs de Spearman
South America	Amérique du Sud
soybean	fève de soja
soybean pod	gousse de soja
space maintenance	maintenance d'espace
spasm	spasme
Spearman's rank correlation	Mesure spécifique
specialist	medecin correspondant
special senses	appareil sensoriel
Specific measure	Taux spécifique
Specific rate	Spécification
specifying the patients' treatment pathway	Précisant aussi le parcours de soins des patients
Spectrum of disease	Spectre d'une maladie
Speech Language Pathologist	Orthophoniste
speech therapy	orthophoniste
sperm function	fonction spermatique
spermicide	spermicide
spider angioma	angiome stellaire
spinal arthritis	arthrite de la colonne vertébrale
spinal corde	moelle epiniere
spinal cord	moelle epinière
spinal curvature	devier la colonne verterbrale
spinal fusion	arthrodèse du rachis
spinal nerve problems	Troubles ou pathologies neurologiques d'origine rachidienne
spinal	rachianesthésie
Spit blood	Cracher du sang
Spit	Cracher
spitting	crachat
spleenocyte	splénocyte
spleen	rate
Spleen rate	Proportion de sujets atteints de splénomégalie
splint	attelle
splintered fracture	fracture esquilleuse
splinting	contraction douloureuse
spontaneous defibrillation	Défibrillation spontanée
spoon dosing	cuillère unidose
spoon feeding	alimentation à la cuillère
Sporadic	Sporadique
Spot map	Carte de répartition des sujets
sprain	entorse
sprain the ankle	fouler la cheville
spread	extension
Spur formation	formation d'ostéophytes
sputum	crachat
sputum	expectoration
sqat	accroupissement
stability	statique
stability testing	mise en stabilité
stabilizing	équilibrantes
Stable population	Population stable
staining	coloration
stand-alone EP studies	les examens ep autonomes
Standard deviation	Ecart-type
Standardization	Standardisation
Standardized measure	Mesure standardisée
Standard metropolitan statistical area	Erreur-type
Standard	Standard
standard ward	hospitalisation en chambre commune
stand by	de réserve
stand by	de secours
Staphylococcus	Staphylocoque
state of the art	dernier cri
Stationary population	Population stationnaire
Statistical error	Erreur statistique
Statistical inference	Inférence statistique
Statistical model	Modèle statistique
Statistical significance	Signification statistique
Statistical test	Test statistique
Statistics	Statistiques
status	statut
steady-state plasma	Concentrations plasmatiques moyennes à l'état d'équilibre
Steady state	Situation d'équilibre
stearic acid	acide stéarique
ST elevation MI	infarctus du myocarde avec surélévation du segment ST
stellate fracture	fracture stellaire
stem cell	cellule souche
steptococcal fascitis	fasciite streptococcique
stepwise deterioration	détérioration progressive
Stereogram	Stéréogramme
sterile field	champ stérile
Sterile gauze	Gaze stérile
Sterile solution	Solution stérile
Sterile	Stérile
Sterilisation	Stérilisation
sterilité	iud
Sterilized wound dressing	Pansement stérilisé
steriod-eluting	à diffusion de stéroïde
sternal synthesis	synthèse sternale
Steroid precursors	Précurseurs stéroïdiens
Steroid	Stéroïde
stiff joints	raideur d'articulation
stiffness	courbatures
stiffness	maladresse
Stillbirth certificate	Déclaration de mortinaissance
Stillbirth	Mortinaissance
Stillbirth rate	Indice de mortinatalité
Stillborn	Mort-né
stippling	piquetée
stirrup	Étrier
St. JohnS Wort	Millepertuis perforé
Stochastic process	Processus stochastique
stomach acid	acidité gastrique
stone	lithiase
stores	réserves
straight connector	connecteur rectiligne
Straight Endovascular Aortic Graft	Endoprothèse aortique droite
strain molecular population dynamics	dynamique moléculaire des souches post-introduction
strain	souche
strain	surcharge
strangulated hernia	hernie étranglée
strapping	bandage adhésif
strapping	emplâtre adhésif
Strata	Strate
Strategy	Stratégie
Stratification	Stratification
Stratified randomization	Echantillonnage aléatoire stratifié Randomisation stratifiée
strength	concentration
strength	la force
Strength of association	Force de l'association
Streptococcus	Streptocoque
stresses	contraintes
stress imaging studies	évaluation de la perfusion sanguine myocardique d'effort par scintigraphie
stress relieving feature	caractéristiques d'élimination des tensions
stress	stress
stress test	preuve d'effort
striated muscle bundles	faisceaux musculaires striés
stroke	accident vasculaire cérebrale
stroke	apoplexie
stroke	AVC
stroke output	débit systolique
stroke volume	volume systolique
strong medications	médicaments pris à forte dose
Struma	Scrofules
strut	entretoise
strut graft	greffon en H
ST segment	segment ST
ST short type	de taille réduite ST
sttemic patholgy	la pathologie syst'emique
stubbornness	têtu
study entry	admission à l'étude
stuffed animal	peluche
subaortic velocity time integral	ITV sous aortique
subcapital fracture of femur	fracture sous-capitale du fémur
subcitrate	sous-citrate
Subclinical disease	Maladie asymptomatique ou subclinique
subconscious mind	subconscience psychique
Subject information and consent form	Note d'information du sujet et formulaire de consentement éclairé
subsalicylate	sous salicylate de bismuth
subselectively	par cathétérisme sélectif
subserous fascia	aponévrose sous-séreuse
substance abuse	consommation de drogue
subtalar joint	articulation astragalo-calcanéenne
Subungual haematoma	Hématome subunguéal
Successful cancers	Cancers ayant réussi à se développer
suck and swallow reflex	réflexes de succion et de déglutition
sucs ?	succinylcholine
suction cup	ventouse
suction pad	ventouse
suction	succion
Sudatory	Sudatoire
sudden cardiac death	mort subite
suddenly	brutalement
Sudoriferous	Sudorifère
Sudorific	Sudorifique
sugar pill	comprimé de sucre
Sulphoconjugation	Action sulphoconjuguée
Sunblock base	Base écran solaire
sunburn	coup de soleil
Sunburn	Coup de soleil
Sun damage	Méfaits du soleil
Sunscreen product	Produit anti-solaire
superficial fascia	aponévrose superficielle
Superior mesenteric artery	SMA
superovulation	super-ovulation
supplemental new drug application	demande d'homologation complémentaire
supplement	complement vitaminique
supplements	complments
supplies	approvisionnement
supplies	fournitures
supply	apport
supplying the brain	destinée cérébrale
supported	approuvé
suppositoire	suppositoire
suppression	Voir ci-dessous
suppurative arthritis	arthrite purulente
Suppurative hidradenitis	Hidrosadénite suppurée
Supra-aortic vessels	SAV
suprarenal hormones	hormones surrénaliennes
supraspinatus fascia	aponévrose sus-épineuse
surface-active agent	agent tensioactif
Surface burn	Brûlure superficielle
Surface wound	Plaie superficielle
surgeon	chirurgien
surgical	chirugicale
surgical	chirurgical
surgical debridement	mise à plat chirurgicale
surgical gloves	gants chirurgicaux
surrogate outcome predictor	critère ou paramètre prédictif de substitution
surrogate	porteuse
surrounding	environnant
Surveillance of disease	Surveillance des maladies
Surveillance	Surveillance
survey	attitudes et habitudes
Survey	Enquête
Survey instrument	Instrument d'enquête
Survey methods	Méthodes d'enquête
Survival analysis	Analyse de survie
Survival curve	Courbe de survie
Survival function	Fonction de survie
Survival rate	Probabilité de survie
Survival ratio	Rapport de survie
Survival table	Table de survie
survivor benefit extension	prolongement des prestations au survivant
Survivorship study	Etude de survie
susceptible	susceptible
Sustained arrhythmia due to atrial fibrillation	SAAF
swab	pelvement  sur ecouillon
sweat canal	canal sudorifère
sweat gland	glande sudoripare
swelling	enflure
swelling	gonflement
switch	en relai
swollen liver	dilatation du foie
Symbiosis	Symbiose
Symmetrical relationship	Relation symétrique
sympathetic dysfunction	dysfonctionnement du sympathique
symptomatic carpal bossing	carpe bossu symptomatique
Symptomatic treatment	Traitement symptomatique
Syndrome	Syndrome
synovial bursa	bourse synoviale
synovial cavity	cavité synoviale
synovial chondromatosis	chondromatose synoviale
synovial sheath	gaine synoviale
Syphilitic ulcer	Ulcère syphillitique
syringe barrel	corps de seringue
syringe pump	seringue autopulsée
Sys	Systolique
system	appareil
Systematic error	Erreur systématique
systemic	général
Systemic lupus erythematosus	Lupus érythémateux disséminé
Systems analysis	Analyse de systèmes
Systolic pressure index	SPI
Systolique	Sys
table	le tableau
tablet	comprimé
Tablet	Tblt
tachycardia	tachycardies
Tachycardie auriculaire complète par fibrillation auriculaire	TACFA
tactile buds	corpuscules tactiles
tactile markers	repères sensoriels
takeover bid	offre public d'achat
taking a few days off for medical reasons	pour cause de soins médicaux
talonavicular joint	articulation astragalo-scaphoïdienne
tandem instrastent restenosis	en tandem intrastent
Tanner's staging method	méthode de cotation Tanner
tantrums	caprices
target cell	cellule cible
target	cible
targetoid	en cible
Target population	Population cible
taxing officer	magistrat taxateur
Taxonomy of disease	Taxinomie des maladies
Taxonomy	Taxinomie
Tblt	Tablet
teat	sucette
template	gabarit
tensioned cable	fil métallique tendu
TENS machine	neurostimulateur électrique percutané
Teratogen	Tératogène
Terbinafine hydrochloride	Chlorydrate de terbinafine
terminal dribbling	fuite postmictionnelle
test bed for Multitest Ejection Force	banc de force d'Ejection Multitest
test characteristics	valeur prédictive ou prévisionnelle
test	examen
Test hypothesis	Test d'hypothèse
Testicle difformities	Difformités du testicule
Testicle luxation	Luxation du testicule
Testicle malformations	Malformations du testicule
Testicle	Testicul
Testis	Testicule
Test of significance	Test de signification
test strips	bandelette diagnostique
Tetter	Dartre
the ablation device as a source of  alternate site burns	occasionner des brûlures à distance du site d'intervention
the buffering of acidity	tamponnement de l'acidité
the data bridged from...	Ci-dessous
... the final containers are filled	...se fait la répartition
the middle third of the patellar tendon	le tiers moyen du TR
the opposite of giving birth	accoucher dans l'autre sens
Theoretical epidemiology	Epidémiologie théorique
Theoretical maximum heart rate	TMHR
the patient reports an euthymic mood	la patient rapporte un humeur eu thymique
Therapeutic Recreation	thérapie récreative
therapeutic tools	outils thérapeutiques
Therapeutic trial	Essai thérapeutique
Therapeutic Use Exemptions TUE	Demande dAutorisation dUsage à des fins Thérapeutiques AUT
Therapy	Thérapie
There is an...	Membre du Bureau Association Chronobiologie Médicale
There is little eye contact today and she is tearful.	Peu de contact visuel avec elle aujourd'hui : elle pleure.
the reversibility of bronchoconstruction	la réversibilité du bronchospasme
the sinus node ages	le noeud sinusal vieillit
the spine and pelvis	lensemble rachis-bassin
the ventricles contract	les ventricules se contractent
thick drop	goutte épaisse
third-degree AV block	bloc auriculo-ventriculaire de troisième degré
Third degree burn	Brûlure du troisième degré
This depends on the  venous drainage pattern	elle est fonction du drainage veineux
This depends on venous drainage	elle est fonction du drainage veineux
thoracic cavity	cavité thoracique
thoracic duct	canal thoracique
thread	filetage
threaten survival	d'engager le pronostic vital
threats	menaces
Threshold limit value	Valeur limite d'exposition
Threshold phenomena	Phénomènes observés au-delà d'un certain seuil Phénomènes de seuil
thrill	frémissement
throbbing headache	la douleur lacinante
thrombocytopenia	thrombocytopénie
thrombophlebitis	TPP
thrombosis	thrombose
through a right transrectal incision	en trans rectal droit
Through concentrations ...above	Concentrations minimales supérieures à ...
throughput	débit
thrush	muguet
thumb spica splint	gantelet résine
thumb-sucking	sucer son pouce
thyroid drug	Les médicaments de la thyroïde
thyroide	thyroide
thyroid gland	glandes thyroides
thyroid nodule	nodule de thyroide
thyroid uptake	fixation thyroidienne
tibiofibular joint	articulation péronéo-tibiale
Tick Borne Encephalitis	encéphalite à tiques
tightness	constriction
tilt table	Table Basculante
Time cluster	Agrégat temporel
time management	gestion de temps
Time-place cluster	Agrégat temporo-spatial
time-to-event data	Les donées relatives au temps avant événement ...
tingling	engourdissement
tingling	fourmalité
tingling	fourmillement
tinnitus	acouphène
tintinitus	acouphène
tissue bundles	faisceaux tissulaires
tissue cuff height	hauteur gingivale
Tissue space	Espace inter-cellulaire
Tissue	Tissu
to accelerate the impulse	accélérer limpulsion
to advertise	annoncer
to anchor an ancillary tool	'pour ancrer un ancillaire'
to apply	appliquer
to apply	avoir recours à
to assign re-supply medication	pour attribuer les renouvellements
to be bound by	etre tenu par
to be life-threatening	mettre en jeu le pronostic vita
to be life-threatening	mettre la vie en danger
to bump	heurter
to cause	provoquer
to circumduct or semicircular spastic gait	fauchage
to clot	se coaguler
to cough up	expectorer
to cure the abnormal rhythm	guérir les troubles du rythme
toddlerhood	petite enfance
to deliver a shock	délivrer un choc
to deslough	enlever les escarres
to detail products	promotion directe de produits
to drop out	abandonner un traitement
Toe-nail growing in	Onglade
Toe	Orteil
to inactivate	désactiver
tolerance dose	dose tolérée
tonsillectomy	ablation des végétations
tonsillitis	adénoïdite
tonsillitis	amygdalite
tonsillitis	amygdalites
tonsillitis	angine
tonsils	végétations adénoïdes
too fast	trop vite
too low heart rate	pouls trop lent
too rapid heart rate	pouls trop rapide
to pass through the AV node	traverser le noeud auriculo-ventriculaire
Topical corticosteroid	Corticostéroïde topique
Topical treatment	Traitement topique
to promote	favoriser
to range from...to...	aller de... à...
to recover	guérir
to relieve	apaiser
torquer	coupleur
torque wrench	clé dynamométrique
Torsion of the testicle	Torsion du testicule
to screen	discriminer
to sedate	sedationner
to spike	faire un clocher
to stage	déterminer les stades d'une maladie
to suction	aspirer
to synchronize	synchroniser
Total hip prosthesis	THP
total interruption of transmission	arrêt de la conduction
Total lung capacity	TLC
Total radical hysterectomy	TRH
total viable microbial count	numération microbienne totale viable
to tame	apprivoiser
to tissue type	faire un typage sérologique
to trigger	déclencher
to trigger off	déclencher
towing dolly	remorqueur
to wipe gross exposure matter	éliminer les souillures
traceability	traçabilité
Tracer disease method	Méthode des maladies indicatrices
trachea is midline	Trachée en position médiane
tracheal cartilage	cartilage de la trachée
tracing	tracé
tracks up and down	diffuse en amont et en aval
tract	système
training	formation
trait anxiety with depressive tendencies	angoisse constitutionnelle à tendance dépressive
tranquillizer	calmant
transcient ischemic attack	accident ischémique transitoire
Transcutaneous Nerve Stimulation	neurostimulation transcutanée
transdermal patch	timbre transderrmique
Transdermal	Transdermique
trans-fatty acid	acides gras trans
Transient ischemic attack	TIA
transient self limiting pyrexia	fièvre transitoire spontanément résolutive
transitional cell neoplasms	carcinomes à cellules transitionnelles
transmetallation	transmétallation
Transmission of infection	Transmission de l'infection
Transovarial transmission	Transmission transovarienne
Transport host	Hôte intermédiaire d'un parasite
trans-septal catheterisation	cathétérisme trans-septal
transthoracic echo	examen trans-thoracique
transverse lie	malposition transverse
transverse sinus of pericardum	sinus de Theile
travel assistance provider	assisteur
treated	trates
treatment approach	approche thérapeutique
treatment as and when needed	traitement ponctuel
treatment-emergent variants	variants émergeant en cours de traitement
Treatment form	Feuille de soins
treatment of constipation-dominant irritable bowel syndrom	traitement du syndrome du côlon irritable avec constipation prédominante
treatment plan proposal	proposition de traitement aux fécondostimulants
Treatment Resistant Major Depressive Disorder	Trouble dépressif majeur pharmacorésistant
tremor	tremblement
Trend line	Droite de tendance
Trend	Tendance
Trial	Essai
trial of drug therapy	essai des médicaments
tricyclic antidepressants	antidépresseurs tricycliques
tried and tested	ayant de l'expérience
trigger	la gachette
Trimetobenzamide HCl	chlorhydrate de triméthobenzamide
trinexapac-ethyl	Trinexapac-éthyle
trisodium citrate	citrate trisodique
Trombidium	Trombidion
trough FEV1	VEMS résiduel
tubules with flattened epithelium	tubes à épithélium aplati
tularemia	tularémie
tumefaction	tuméfaction
tumoral lesion	atteinte tumorale
tumors	tumeurs
tumor	tumeur
tumour cell	cellule tumorale
tumour nocrosis factor	facteur nécrosant des tumeurs
tumour	tumeur
tunnel of Corti	canal de Corti
Turn of duty	Tour
Tutorial benefits	Prestations pour enseignement individuel
T wave	onde T
twice a day	deux fois par jour
Twin pairs	Paires de jumeaux
Twin study	Etude de jumeaux
twitching	secousse musculaie elementaire
Two-tail test	Test de signification bilatéral
type 1 diabetes	diabète type 1
type examination	examen de type
Type I error	Erreur de première espèce
Type II error	Erreur de deuxième espèce
typical pattern	aspect particulier
typology	typologie
Tyson's gland	glande de Tyson
UA negative	Examen des urines négatif
ulcerative colitis	colite ulcéreuse
ulcers of stomach or bowels	ulcères de lestomac ou des intestins
Ulcer	Ulcère
Ulcus venereum	Ulcus venereum
ulna	cubitus
ulnar	cubital
ultasound	echographie
umbilical hernia	hernie ombilicale
u-MRI	C'est le U de ultrasounds
unattained GP	potentiel de croissance non atteint
Unbiassed estimator	Estimateur non biaisé
unconditional and conditional schemas	scémas inconditionnels et conditionnels
Uncontrolled variable	Variable incontrôlée
Underestimation	Sous-estimation
undergraduate and postgraduate programmes	programmes de formation pré-doctorants et post-doctorants
Underlying cause of death	Cause sous-jacente du décès Cause initiale du décès
underlying	le lit de la plaie
Underreporting	Sous-déclaration
undersigned	soussignes
undo	dėfaire
UNGASS - United Nations General Assembly Special Session on Children	Session extraordinaire de l'Assemblée générale des Nations Unies consacrée aux enfants
Unit dose blister strip	bande alvéolée thermoformée
unit dose delivery	délivrance à l'unité
United States	Etats-Unis
Unité Générale - General hospital unit	UG
University Medical Center	UMC
unremarkable	sp.
unscheduled drug product	produit pharmaceutique en vente libre
unset	non défini
unstable angina	angor instable
upper limbs	membres supérieurs
upper lobe branch of the right pulmonary artery	médiastinale
upper tooth	dent supérieur
upward deflection	déflexion vers le haut
upward	vers le haut
Urea	Urée
Uremic frost	Givre urémique
urgency	besoin impérieux
urgent care	turbulence medicale
uric acid	acide urique
urinalysis	examen des urines
Urinary albumin excretion	UAE
urinary infection	infection urinaire
urinary tract infection	infection de tract urinaire
Urinary tract obstruction	Obstruction des voies urinaires
urine culture	ECBU
urine dipstick	bandelette urinaire
Urine microscopy and culture	UMC
Urticaria	Urticaire
used in breeding	utilisés à des fins de reproduction
user fees	frais dutilisateur
user friendly	convivial
using a basket forceps	à la pince
uterine fibroids	fibromes utérin
uterine fibroids	fibromes utérins
uterine fibrosis	fibrome uterine
uterine tissue	endomètre
Utility	Utilité
UV rays	Rayons UV
Vaccination	Vaccination
Vaccine	Vaccin
Vacuole	Vacuole
vaginal bleeding of unknown cause	saignements vaginaux non diagnostiqués
vaginal candidiasis	candidose vaginale
vaginal delivery	accouchement par voie basse
vaginal flora	flore vaginale
vaginal yeast	mycose vaginale
Validation	Validation
Validity	Validité
value of micro-dialysis	intérêt de la micro-dialyse
valvular defect	affection valvulaire
valvular disease	valvulopathies
Vanishing cream	Crème évanescente
Variable	Variable
Variance	Variance
Variate	Variable aléatoire
Varicosa eczema	Eczéma variqueux
varicose veins	varices
Variola	Variole
Vascular insufficiency	Insuffisance vasculaire
vascular prosthesis	prothèse vasculaire
vascular puncture	ponction
Vascular system	Système vasculaire
vascular tree	arbre vasculaire
Vascular	Vasculaire
Vasculitis	Angéite
vaseline > wsp > pet.	vas.
Vasodilating	Vasodilatateur
vasoregulation	régulation vasculaire
Vector-borne infection	Infection transmise par vecteur
Vector space	Espace vectoriel
Vector	Vecteur
vehicle-controlled study	contrôlé par excipient
Vehicle of infection transmission	Véhicule de transmission de l'infection
vein dissection	déchirement de la paroi de la veine
vein-lifting device	souleve-veine
Venereal disease	Maladie vénérienne
Venereal wart	Condylome
Venn diagram	Diagramme de Venn
venous catheterisation	cathétérisme veineux
venous plexus	réseau veineux
ventilatory weaning	la sevrage ventilatoire
ventral horn cell	cellule de la corne antérieure
ventricle	ventricule
ventricular fibrillation	fibrillation ventriculaire
ventricular sensing	l'écoute du ventricule
ventricular shunt	dérivation ventriculaire
ventricular tachycardias	tachycardies ventriculaires
ventricular wall	cloison du ventricule
ventrogluteal and dorsogluteal	quadrant antéro-externe et quadrant supéro-externe du muscle fessier
verification	vérification
vertebral body	corps vertébral
vertigo	vertige
very superficial	très superficiel
Vesicle	Vésicule
Vesicoureteral reflux	Reflux vésico-urétéral
vicryl	vicryl
Viral hepatitis	Hépatite virale
Virgin population	Population vierge
Virulence	Virulence
visceral cavity	cavité splanchnique
visceral fascia	aponévrose viscérale
visceral pericardium	feuillet viscéral du péricarde
viscous work of breathing	résistance visqueuse
vision training	Rééducation de loeil
visual field	champ visuel
Vital records	Registres de l'état civil
vitamin B12 deficiency	carence en vitamine B12
Vitiligo	Vitiligo
VlsE1 IgG + pepC10 IgM	Ci-dessous
Volatile	Volatile
walk	démarche
walker	déambulateur
wall	cloison
wall	paroi
warn	mettre au clair
warrant	mandat
warts	verrue
Wart	Verrue
wash out effect	perte de contraste par surluminosité
waste	déchets
wasting paralysis	atrophie musculaire progressive
water balance	bilan hydrique
water-soluble	hydrosoluble
watertight circular anastomosis	Anastomose circulaire bien étache
waveform	signal
wax in ears	cire
weaning	sevrage
Webbed penis	Verge palmée
wedge biopsy	biopsie en coin
wedge-like formation	curiéiformisation
wedge-shaped fractures of the spine	tassements vertébraux cunéiformes
weeping dermatitis	dermatose suintante
weeping dermatitis	eczéma suintant
weight-bearing cartilage	cartilage porteur
Weighted average	Moyenne pondérée
weighted fit	ajustement pondéré
weighted retractor	valve à poids
weight	poids
Weight	Poids
wheat grass	agopyre
wheelchair	fauteuil roulant
wheezing	sifflement respiratoire
when the leg is dependent	jambe pendante OU en position déclive
when there are no episodes of bleeding	à distance de
which are not large enough to be flare-ups	qui n'ont absolument pas l'ampleur d'un flare-up
while being of critical importance	Pour être déterminantes
White blood cells	WBC
white cell	globule blanc
White cell pellet	La coloration  des culots leucocytaires ...
white collagenous fibrocartilage	cartilage fibreux collagène
white discharge	perte blanche
Whitlow	Panaris
who initially transmitted a message of solution	qui ont fait savoir tout de suite que le problème était résolu
whooping cough	coqueluche
whooping cough	Coqueluche
WHO - World Health Organization	OMS - Organisation mondiale de la Santé
WHO  World Health Organization	OMS  Organisation mondiale de la santé
wide-bore	grand calibre
wildly racing	cadence effrénée
windpipe	trachee
wire	fil
wishes	volontés
with an INR between 2.5 and 3.5	avec un INR entre 2.5 et 3.5.
with a rapid heart rate	battent rapidement
with a safety margin of	avec sécurité à
with correction of haematological disorders when the medication is stopped	avec correction des troubles hématologiques à la suppression du médicament
Withdrawn alive	Exclus vivants
without radicular involvement	sans conflit ostéoradiculaire
with respect to that portion of the sentence that exceeds the period of detention already served	pour de ce qui dépasse la détention déjà subie
worker's compensation	l'assurance maladie-invalidité
worksheet	feuille
work shift	poste
workup	bilan
World Health Authorities	autorités sanitaires internationales
world wide	au niveau mondial
Worm count	Décompte des vers
Worm	Ver
Wormwood	Absinthe
wound	plaie
Wrinkle	Ride
Wrisberg's cartilage	cartilage de Morgagni
Xenobiotic	Xénobiotique
Xenodiagnosis	Xénodiagnostic
X has expanded the scope of its information campaigns	x a élargi le registre de ses actions dinformation
Yates' correction	Correction de Yates
yawning	baillement
yeast	mycose vaginal
yellow elastic fibrocartilage	cartilage fibreux élastique
Yellow fever	fièvre jaune
Zeis' gland	glande de Zeis
Zero-time shift	Déplacement du temps zéro
zinc citrate	citrate de zinc
Zoonosis	Zoonose
ZZZ™ wafers	implants ZZZ™
AAA	AAA
ABDOMINAL PAIN	douleur abdominale
ACR	ACR
ADL	AVQ
AIBD	arthropathies des MICI
AI	IA
A LUMP	UNE GROSSEUR
AP	antéro-postérieur
B12	B12
BACKACHE	MAL DE REINS
BID	bi-quotidien
BNCT	BNCT
CAE	CAE
CAV	CAV
CAVE	CAVE
CBC	FSC
CB	PC
CDAI	CDAI
CERVIX	COL D'UTERUS
CEV	CEV
CHEST PAIN	DOULEUR DE POITRINE
COMP	COMP
COUGH	TOUX
COX-1	COX-1
COX-2	COX-2
CPT-11	CPT-11
DIARRHEA	DIARRHEE
DIZZY	VERTIGE
DL-....	Acide DL-aspartique
DREZ	DREZ
DSA	ASD - Angiogrphie par soustraction digitale
EXCESS SWEATING	TRANSPIRATION EXCESSIVE
EXTENDED ROD CONTOURING LINKAGE	appareil de contournage de tringle et méthode d'extension
FATIGUE	FATIGUE
FEVER	FIEVRE
FLANK PAIN	DOULEUR AU FLANC
FLUSHING	ROUGEURS
GGT	GGT
HEADACHE	MAL DE TETE
HIDE	CACHE
HIV	VIH virus de l'imune deficience humain
ICHPPC	CIPSSPL
ICU	station de soins intensifs
ID	diamètre intérieur
IDDM	DID
IMC  BMI	MC
ITCHING	DEMANGEAISON
JAUNDICE	JAUNISSE
LAD	IVA
LEG PAIN	DOULEUR DANS LA JAMBE
LMWH	HBPM
LOSS OF CONSCIOUSNESS	PERTE DE CONSCIENCE
MD	docteur en médecine
MSDS	FDS
N	azote
NSAID	AINS
NST	TNS
NUMBNESS AND TINGLING	ENGOURDISSEMENT ET FOURMILLEMENT
OD	diamètre extérieur
PCS	CP
PPAR	PPAR
PTCA	ACPT
PTCA	angioplastie transluminale percutanée
P.U.V.A.	thérapie de rayonnement ultraviolet
QALY	Survie ajustée pour la qualité de vie
SCLC	CPPC
SD	écart type
SEIZURES	ATTAQUES
SHORTNESS OF BREATH	manque de souffle
SORE THROAT	MAL DE GORGE
SWAB TEST	PRELEVEMENT ECOUVILLON
SWOLLEN BELLY	VENTRE GONFLE
SWOLLEN JOINTS	INFLAMMATION DES ARTICULATIONS
SWOLLEN LEGS	JAMBES ENFLEES
TACFA	Tachycardie auriculaire complète par fibrillation auriculaire
TB	tuberculose
TIA	AIT
TPP	thrombophlebitis
ULTRASOUND	ULTRASON
VES	ESV
WARNINGS	AVERTISSEMENT
